>pos_control_apFAB63	ACCTGTAATTCCAAGCGTCTGCACGAATATTCAGTTAGTGGGTTACCGTTATTCGACCAGCGGATATTTTAATTTCGCTGATACAACATACAGTCGAATGAATGGCTACAACATCGAACTCGAGGGCGCGCCTTGACAATTAATCATCCGGCTCGTAGATTTAACGTATAAAGCGCTAGCGGTGTTTAGTTAGCATCC
>pos_control_apFAB61	ACCTGTAATTCCAAGCGTCTGCACGAATATTCAGTTAGTGGGTTACCGTTATTCGACCAGCGGATATTTTAATTTCGCTGATACAACATACAGTCGAATGAATGGCTACAACATCGAACTCGAGGGCGCGCCTTGACAATTAATCATCCGGCTCGTATAATAGATTCATTAGAGGCTAGCGGTGTTTAGTTAGCATCC
>pos_control_apFAB66	ACCTGTAATTCCAAGCGTCTGCACGAATATTCAGTTAGTGGGTTACCGTTATTCGACCAGCGGATATTTTAATTTCGCTGATACAACATACAGTCGAATGAATGGCTACAACATCGAACTCGAGGGCGCGCCTTGACATCAGGAAAATTTTTCTGTATAATAGATTCATCTCAAGCTAGCGGTGTTTAGTTAGCATCC
>pos_control_apFAB64	ACCTGTAATTCCAAGCGTCTGCACGAATATTCAGTTAGTGGGTTACCGTTATTCGACCAGCGGATATTTTAATTTCGCTGATACAACATACAGTCGAATGAATGGCTACAACATCGAACTCGAGGGCGCGCCTTGACATCAGGAAAATTTTTCTGATACTTACAGCCATACCTAGCTAGCGGTGTTTAGTTAGCATCC
>pos_control_apFAB65	ACCTGTAATTCCAAGCGTCTGCACGAATATTCAGTTAGTGGGTTACCGTTATTCGACCAGCGGATATTTTAATTTCGCTGATACAACATACAGTCGAATGAATGGCTACAACATCGAACTCGAGGGCGCGCCTTGACATCAGGAAAATTTTTCTGTATAATGTGTGGATTCGTAGCTAGCGGTGTTTAGTTAGCATCC
>pos_control_apFAB69	ACCTGTAATTCCAAGCGTCTGCACGAATATTCAGTTAGTGGGTTACCGTTATTCGACCAGCGGATATTTTAATTTCGCTGATACAACATACAGTCGAATGAATGGCTACAACATCGAACTCGAGGGCGCGCCTTGACATCGCATCTTTTTGTACCATACTTACAGCCATTGTACGCTAGCGGTGTTTAGTTAGCATCC
>pos_control_apFAB98	ACCTGTAATTCCAAGCGTCTGCACGAATATTCAGTTAGTGGGTTACCGTTATTCGACCAGCGGATATTTTAATTTCGCTGATACAACATACAGTCGAATGAATGGCTCTCGAGGGCGCGCCAAAAAATTTATTTGCTTTCGCATCTTTTTGTACCTAGATTTAACGTATCCCGAGCTAGCGGTGTTTAGTTAGCATCC
>pos_control_apFAB97	ACCTGTAATTCCAAGCGTCTGCACGAATATTCAGTTAGTGGGTTACCGTTATTCGACCAGCGGATATTTTAATTTCGCTGATACAACATACAGTCGAATGAATGGCTCTCGAGGGCGCGCCAAAAAATTTATTTGCTTTCGCATCTTTTTGTACCCATAATTATTTCATCTTCTGCTAGCGGTGTTTAGTTAGCATCC
>pos_control_apFAB96	ACCTGTAATTCCAAGCGTCTGCACGAATATTCAGTTAGTGGGTTACCGTTATTCGACCAGCGGATATTTTAATTTCGCTGATACAACATACAGTCGAATGAATGGCTCTCGAGGGCGCGCCAAAAAATTTATTTGCTTTCGCATCTTTTTGTACCTATAATAGATTCATTGGCCGCTAGCGGTGTTTAGTTAGCATCC
>pos_control_apFAB94	ACCTGTAATTCCAAGCGTCTGCACGAATATTCAGTTAGTGGGTTACCGTTATTCGACCAGCGGATATTTTAATTTCGCTGATACAACATACAGTCGAATGAATGGCTCTCGAGGGCGCGCCAAAAAATTTATTTGCTTTCGCATCTTTTTGTACCATACTTACAGCCATTACTGGCTAGCGGTGTTTAGTTAGCATCC
>pos_control_apFAB67	ACCTGTAATTCCAAGCGTCTGCACGAATATTCAGTTAGTGGGTTACCGTTATTCGACCAGCGGATATTTTAATTTCGCTGATACAACATACAGTCGAATGAATGGCTACAACATCGAACTCGAGGGCGCGCCTTGACATCAGGAAAATTTTTCTGCATAATTATTTCATATCACGCTAGCGGTGTTTAGTTAGCATCC
>pos_control_apFAB341	ACCTGTAATTCCAAGCGTCTGCACGAATATTCAGTTAGTGGGTTACCGTTATTCGACCAGCGGATATTTTAATTTCGCTGATACAACATACAGTCGAATGAATGGCTACAACATCGAAACTCGAGGGCGCGCCTTGACAATTAATCATCCGGCTCGTAATATGTGTGGATGGTTGCTAGCGGTGTTTAGTTAGCATCC
>pos_control_apFAB339	ACCTGTAATTCCAAGCGTCTGCACGAATATTCAGTTAGTGGGTTACCGTTATTCGACCAGCGGATATTTTAATTTCGCTGATACAACATACAGTCGAATGAATGGCTACAACATCGAAACTCGAGGGCGCGCCTTGACAATTAATCATCCGGCTCGTAATTTATGTGGATAGGAGCTAGCGGTGTTTAGTTAGCATCC
>pos_control_apFAB338	ACCTGTAATTCCAAGCGTCTGCACGAATATTCAGTTAGTGGGTTACCGTTATTCGACCAGCGGATATTTTAATTTCGCTGATACAACATACAGTCGAATGAATGGCTACAACATCGAAACTCGAGGGCGCGCCTTGACAATTAATCATCCGGCTCCTAGGATGTGTGGAGGGACGCTAGCGGTGTTTAGTTAGCATCC
>pos_control_apFAB29	GGATGCTAACTAAACACCGCTAGCGCTGGATGGCTGTAAGTATCCTATAGGTTAGACTTTAAGTCAATACTCTTTTTGGCGCGCCCTCGAGAGCCATTCATTCGACTGTATGTTGTATCAGCGAAATTAAAATATCCGCTGGTCGAATAACGGTAACCCACTAACTGAATATTCGTGCAGACGCTTGGAATTACAGGT
>pos_control_apFAB150	ACCTGTAATTCCAAGCGTCTGCACGAATATTCAGTTAGTGGGTTACCGTTATTCGACCAGCGGATATTTTAATTTCGCTGATACAACATACAGTCGAATGAATGGCTACACTCGAGGGCGCGCCCACGGTGTTAGACATTTATCCCTTGCGGCGATATAATGTGTGGATCCATAGCTAGCGGTGTTTAGTTAGCATCC
>pos_control_apFAB58	ACCTGTAATTCCAAGCGTCTGCACGAATATTCAGTTAGTGGGTTACCGTTATTCGACCAGCGGATATTTTAATTTCGCTGATACAACATACAGTCGAATGAATGGCTACAACATCGACTCGAGGGCGCGCCTTGACATAAAGTCTAACCTATAGGTAGATTTAACGTATTCTGAGCTAGCGGTGTTTAGTTAGCATCC
>pos_control_apFAB53	ACCTGTAATTCCAAGCGTCTGCACGAATATTCAGTTAGTGGGTTACCGTTATTCGACCAGCGGATATTTTAATTTCGCTGATACAACATACAGTCGAATGAATGGCTACTCGAGGGCGCGCCAAAAAGAGTATTGACTTTTATCCCTTGCGGCGATAGATTTAACGTATCGGGAGCTAGCGGTGTTTAGTTAGCATCC
>pos_control_apFAB52	ACCTGTAATTCCAAGCGTCTGCACGAATATTCAGTTAGTGGGTTACCGTTATTCGACCAGCGGATATTTTAATTTCGCTGATACAACATACAGTCGAATGAATGGCTACTCGAGGGCGCGCCAAAAAGAGTATTGACTTTTATCCCTTGCGGCGACATAATTATTTCATAGTTCGCTAGCGGTGTTTAGTTAGCATCC
>pos_control_apFAB57	ACCTGTAATTCCAAGCGTCTGCACGAATATTCAGTTAGTGGGTTACCGTTATTCGACCAGCGGATATTTTAATTTCGCTGATACAACATACAGTCGAATGAATGGCTACAACATCGACTCGAGGGCGCGCCTTGACATAAAGTCTAACCTATAGGCATAATTATTTCATCCGACGCTAGCGGTGTTTAGTTAGCATCC
>pos_control_apFAB56	GGATGCTAACTAAACACCGCTAGCTCACTATGAATCTATTATACCTATAGGTTAGACTTTATGTCAAGGCGCGCCCTCGAGTCGATGTTGTAGCCATTCATTCGACTGTATGTTGTATCAGCGAAATTAAAATATCCGCTGGTCGAATAACGGTAACCCACTAACTGAATATTCGTGCAGACGCTTGGAATTACAGGT
>pos_control_apFAB55	ACCTGTAATTCCAAGCGTCTGCACGAATATTCAGTTAGTGGGTTACCGTTATTCGACCAGCGGATATTTTAATTTCGCTGATACAACATACAGTCGAATGAATGGCTACAACATCGACTCGAGGGCGCGCCTTGACATAAAGTCTAACCTATAGGTATAATGTGTGGATCTGGCGCTAGCGGTGTTTAGTTAGCATCC
>pos_control_apFAB54	GGATGCTAACTAAACACCGCTAGCCTTGTATGGCTGTAAGTATCCTATAGGTTAGACTTTATGTCAAGGCGCGCCCTCGAGTCGATGTTGTAGCCATTCATTCGACTGTATGTTGTATCAGCGAAATTAAAATATCCGCTGGTCGAATAACGGTAACCCACTAACTGAATATTCGTGCAGACGCTTGGAATTACAGGT
>pos_control_apFAB277	ACCTGTAATTCCAAGCGTCTGCACGAATATTCAGTTAGTGGGTTACCGTTATTCGACCAGCGGATATTTTAATTTCGCTGATACAACATACAGTCGAATGAATGGCTACAACATCGAAACTCGAGGGCGCGCCTTCCCTATTAATCATCCGGCTCGTATAATGTGTGGAATTTAGCTAGCGGTGTTTAGTTAGCATCC
>pos_control_apFAB115	ACCTGTAATTCCAAGCGTCTGCACGAATATTCAGTTAGTGGGTTACCGTTATTCGACCAGCGGATATTTTAATTTCGCTGATACAACATACAGTCGAATGAATGGCTACAACATCGAACTCGAGGGCGCGCCTCGACATCAGGAAAATTTTTCTGTATAATGTGTGGATCTACAGCTAGCGGTGTTTAGTTAGCATCC
>pos_control_apFAB114	ACCTGTAATTCCAAGCGTCTGCACGAATATTCAGTTAGTGGGTTACCGTTATTCGACCAGCGGATATTTTAATTTCGCTGATACAACATACAGTCGAATGAATGGCTACAACATCGAACTCGAGGGCGCGCCTCGACATCAGGAAAATTTTTCTGATACTTACAGCCATGCGGAGCTAGCGGTGTTTAGTTAGCATCC
>pos_control_BBa_J23105	ACCTGTAATTCCAAGCGTCTGCACGAATATTCAGTTAGTGGGTTACCGTTATTCGACCAGCGGATATTTTAATTTCGCTGATACAACATACAGTCGAATGAATGGCTACAACATCGAAACCTCGAGGGCGCGCCTTTACGGCTAGCTCAGTCCTAGGTACTATGCTAGCAAGGTGCTAGCGGTGTTTAGTTAGCATCC
>pos_control_apFAB89	ACCTGTAATTCCAAGCGTCTGCACGAATATTCAGTTAGTGGGTTACCGTTATTCGACCAGCGGATATTTTAATTTCGCTGATACAACATACAGTCGAATGAATGGCTCTCGAGGGCGCGCCAAAAAATTTATTTGCTTTCAGGAAAATTTTTCTGATACTTACAGCCATATTATGCTAGCGGTGTTTAGTTAGCATCC
>pos_control_BBa_J23108	GGATGCTAACTAAACACCGCTAGCCGGTGGCTAGCATTATACCTAGGACTGAGCTAGCTGTCAGGGCGCGCCCTCGAGGTTTCGATGTTGTAGCCATTCATTCGACTGTATGTTGTATCAGCGAAATTAAAATATCCGCTGGTCGAATAACGGTAACCCACTAACTGAATATTCGTGCAGACGCTTGGAATTACAGGT
>pos_control_apFAB85	ACCTGTAATTCCAAGCGTCTGCACGAATATTCAGTTAGTGGGTTACCGTTATTCGACCAGCGGATATTTTAATTTCGCTGATACAACATACAGTCGAATGAATGGCTCTCGAGGGCGCGCCAAAAAATTTATTTGCTTATTAATCATCCGGCTCGTATAATGTGTGGATACCGCGCTAGCGGTGTTTAGTTAGCATCC
>pos_control_apFAB87	ACCTGTAATTCCAAGCGTCTGCACGAATATTCAGTTAGTGGGTTACCGTTATTCGACCAGCGGATATTTTAATTTCGCTGATACAACATACAGTCGAATGAATGGCTCTCGAGGGCGCGCCAAAAAATTTATTTGCTTATTAATCATCCGGCTCGCATAATTATTTCATTGGGGGCTAGCGGTGTTTAGTTAGCATCC
>pos_control_apFAB80	ACCTGTAATTCCAAGCGTCTGCACGAATATTCAGTTAGTGGGTTACCGTTATTCGACCAGCGGATATTTTAATTTCGCTGATACAACATACAGTCGAATGAATGGCCTCGAGGGCGCGCCAAAAAATTTATTTGCTTTAAAGTCTAACCTATAGGTATAATGTGTGGATACAGAGCTAGCGGTGTTTAGTTAGCATCC
>pos_control_apFAB81	ACCTGTAATTCCAAGCGTCTGCACGAATATTCAGTTAGTGGGTTACCGTTATTCGACCAGCGGATATTTTAATTTCGCTGATACAACATACAGTCGAATGAATGGCCTCGAGGGCGCGCCAAAAAATTTATTTGCTTTAAAGTCTAACCTATAGGTATAATAGATTCATCTCTTGCTAGCGGTGTTTAGTTAGCATCC
>pos_control_apFAB82	ACCTGTAATTCCAAGCGTCTGCACGAATATTCAGTTAGTGGGTTACCGTTATTCGACCAGCGGATATTTTAATTTCGCTGATACAACATACAGTCGAATGAATGGCCTCGAGGGCGCGCCAAAAAATTTATTTGCTTTAAAGTCTAACCTATAGGCATAATTATTTCATGGTCCGCTAGCGGTGTTTAGTTAGCATCC
>pos_control_apFAB95	ACCTGTAATTCCAAGCGTCTGCACGAATATTCAGTTAGTGGGTTACCGTTATTCGACCAGCGGATATTTTAATTTCGCTGATACAACATACAGTCGAATGAATGGCTCTCGAGGGCGCGCCAAAAAATTTATTTGCTTTCGCATCTTTTTGTACCTATAATGTGTGGATAATAAGCTAGCGGTGTTTAGTTAGCATCC
>pos_control_apFAB93	ACCTGTAATTCCAAGCGTCTGCACGAATATTCAGTTAGTGGGTTACCGTTATTCGACCAGCGGATATTTTAATTTCGCTGATACAACATACAGTCGAATGAATGGCTCTCGAGGGCGCGCCAAAAAATTTATTTGCTTTCAGGAAAATTTTTCTGTAGATTTAACGTATGCCCAGCTAGCGGTGTTTAGTTAGCATCC
>pos_control_apFAB92	ACCTGTAATTCCAAGCGTCTGCACGAATATTCAGTTAGTGGGTTACCGTTATTCGACCAGCGGATATTTTAATTTCGCTGATACAACATACAGTCGAATGAATGGCTCTCGAGGGCGCGCCAAAAAATTTATTTGCTTTCAGGAAAATTTTTCTGCATAATTATTTCATGGAGCGCTAGCGGTGTTTAGTTAGCATCC
>pos_control_apFAB302	ACCTGTAATTCCAAGCGTCTGCACGAATATTCAGTTAGTGGGTTACCGTTATTCGACCAGCGGATATTTTAATTTCGCTGATACAACATACAGTCGAATGAATGGCTACAACATCGAAACTCGAGGGCGCGCCTTCCCTTTTAATCATCCGGCTCGTATAATGTGTGGAGACTTGCTAGCGGTGTTTAGTTAGCATCC
>pos_control_apFAB300	ACCTGTAATTCCAAGCGTCTGCACGAATATTCAGTTAGTGGGTTACCGTTATTCGACCAGCGGATATTTTAATTTCGCTGATACAACATACAGTCGAATGAATGGCTACAACATCGAAACTCGAGGGCGCGCCTTGCCGCTTAATCATCCGGCTCGTATAATGTGTGGATCTTCGCTAGCGGTGTTTAGTTAGCATCC
>pos_control_apFAB306	ACCTGTAATTCCAAGCGTCTGCACGAATATTCAGTTAGTGGGTTACCGTTATTCGACCAGCGGATATTTTAATTTCGCTGATACAACATACAGTCGAATGAATGGCTACAACATCGAAACTCGAGGGCGCGCCTTGACAATTAATCATCCGGCTCGTAGTGTTTGTGGATGTTGGCTAGCGGTGTTTAGTTAGCATCC
>pos_control_apFAB48	ACCTGTAATTCCAAGCGTCTGCACGAATATTCAGTTAGTGGGTTACCGTTATTCGACCAGCGGATATTTTAATTTCGCTGATACAACATACAGTCGAATGAATGGCTACTCGAGGGCGCGCCAAAAAGAGTATTGACTTCGCATCTTTTTGTACCTAGATTTAACGTATTACCAGCTAGCGGTGTTTAGTTAGCATCC
>pos_control_apFAB49	ACCTGTAATTCCAAGCGTCTGCACGAATATTCAGTTAGTGGGTTACCGTTATTCGACCAGCGGATATTTTAATTTCGCTGATACAACATACAGTCGAATGAATGGCTACTCGAGGGCGCGCCAAAAAGAGTATTGACTTTTATCCCTTGCGGCGAATACTTACAGCCATGTAGAGCTAGCGGTGTTTAGTTAGCATCC
>pos_control_BBa_J23116	ACCTGTAATTCCAAGCGTCTGCACGAATATTCAGTTAGTGGGTTACCGTTATTCGACCAGCGGATATTTTAATTTCGCTGATACAACATACAGTCGAATGAATGGCTACAACATCGAAACCTCGAGGGCGCGCCTTGACAGCTAGCTCAGTCCTAGGGACTATGCTAGCAGGATGCTAGCGGTGTTTAGTTAGCATCC
>pos_control_BBa_J23117	ACCTGTAATTCCAAGCGTCTGCACGAATATTCAGTTAGTGGGTTACCGTTATTCGACCAGCGGATATTTTAATTTCGCTGATACAACATACAGTCGAATGAATGGCTACAACATCGAAACCTCGAGGGCGCGCCTTGACAGCTAGCTCAGTCCTAGGGATTGTGCTAGCCAATCGCTAGCGGTGTTTAGTTAGCATCC
>pos_control_BBa_J23114	ACCTGTAATTCCAAGCGTCTGCACGAATATTCAGTTAGTGGGTTACCGTTATTCGACCAGCGGATATTTTAATTTCGCTGATACAACATACAGTCGAATGAATGGCTACAACATCGAAACCTCGAGGGCGCGCCTTTATGGCTAGCTCAGTCCTAGGTACAATGCTAGCCATACGCTAGCGGTGTTTAGTTAGCATCC
>pos_control_BBa_J23115	ACCTGTAATTCCAAGCGTCTGCACGAATATTCAGTTAGTGGGTTACCGTTATTCGACCAGCGGATATTTTAATTTCGCTGATACAACATACAGTCGAATGAATGGCTACAACATCGAAACCTCGAGGGCGCGCCTTTATAGCTAGCTCAGCCCTTGGTACAATGCTAGCGCCTGGCTAGCGGTGTTTAGTTAGCATCC
>pos_control_apFAB40	ACCTGTAATTCCAAGCGTCTGCACGAATATTCAGTTAGTGGGTTACCGTTATTCGACCAGCGGATATTTTAATTTCGCTGATACAACATACAGTCGAATGAATGGCTACTCGAGGGCGCGCCAAAAAGAGTATTGACTTCAGGAAAATTTTTCTGTATAATGTGTGGATGTTCAGCTAGCGGTGTTTAGTTAGCATCC
>pos_control_BBa_J23118	ACCTGTAATTCCAAGCGTCTGCACGAATATTCAGTTAGTGGGTTACCGTTATTCGACCAGCGGATATTTTAATTTCGCTGATACAACATACAGTCGAATGAATGGCTACAACATCGAAACCTCGAGGGCGCGCCTTGACGGCTAGCTCAGTCCTAGGTATTGTGCTAGCCGTCGGCTAGCGGTGTTTAGTTAGCATCC
>pos_control_BBa_J23119	GGATGCTAACTAAACACCGCTAGCTTCGTGCTAGCATTATACCTAGGACTGAGCTAGCTGTCAAGGCGCGCCCTCGAGGTTTCGATGTTGTAGCCATTCATTCGACTGTATGTTGTATCAGCGAAATTAAAATATCCGCTGGTCGAATAACGGTAACCCACTAACTGAATATTCGTGCAGACGCTTGGAATTACAGGT
>pos_control_apFAB44	ACCTGTAATTCCAAGCGTCTGCACGAATATTCAGTTAGTGGGTTACCGTTATTCGACCAGCGGATATTTTAATTTCGCTGATACAACATACAGTCGAATGAATGGCTACTCGAGGGCGCGCCAAAAAGAGTATTGACTTCGCATCTTTTTGTACCATACTTACAGCCATGAAGTGCTAGCGGTGTTTAGTTAGCATCC
>pos_control_apFAB45	ACCTGTAATTCCAAGCGTCTGCACGAATATTCAGTTAGTGGGTTACCGTTATTCGACCAGCGGATATTTTAATTTCGCTGATACAACATACAGTCGAATGAATGGCTACTCGAGGGCGCGCCAAAAAGAGTATTGACTTCGCATCTTTTTGTACCTATAATGTGTGGATAGCGGGCTAGCGGTGTTTAGTTAGCATCC
>pos_control_apFAB46	ACCTGTAATTCCAAGCGTCTGCACGAATATTCAGTTAGTGGGTTACCGTTATTCGACCAGCGGATATTTTAATTTCGCTGATACAACATACAGTCGAATGAATGGCTACTCGAGGGCGCGCCAAAAAGAGTATTGACTTCGCATCTTTTTGTACCTATAATAGATTCATTGCTAGCTAGCGGTGTTTAGTTAGCATCC
>pos_control_apFAB47	ACCTGTAATTCCAAGCGTCTGCACGAATATTCAGTTAGTGGGTTACCGTTATTCGACCAGCGGATATTTTAATTTCGCTGATACAACATACAGTCGAATGAATGGCTACTCGAGGGCGCGCCAAAAAGAGTATTGACTTCGCATCTTTTTGTACCCATAATTATTTCATTCACAGCTAGCGGTGTTTAGTTAGCATCC
>pos_control_apFAB62	ACCTGTAATTCCAAGCGTCTGCACGAATATTCAGTTAGTGGGTTACCGTTATTCGACCAGCGGATATTTTAATTTCGCTGATACAACATACAGTCGAATGAATGGCTACAACATCGAACTCGAGGGCGCGCCTTGACAATTAATCATCCGGCTCGCATAATTATTTCATTTCAGGCTAGCGGTGTTTAGTTAGCATCC
>pos_control_apFAB346	ACCTGTAATTCCAAGCGTCTGCACGAATATTCAGTTAGTGGGTTACCGTTATTCGACCAGCGGATATTTTAATTTCGCTGATACAACATACAGTCGAATGAATGGCTACAACATCGAAACTCGAGGGCGCGCCTTGACAATTAATCATCCGGCTCGTAATGTTTGTGGATAGCTGCTAGCGGTGTTTAGTTAGCATCC
>pos_control_apFAB347	ACCTGTAATTCCAAGCGTCTGCACGAATATTCAGTTAGTGGGTTACCGTTATTCGACCAGCGGATATTTTAATTTCGCTGATACAACATACAGTCGAATGAATGGCTACAACATCGAAACTCGAGGGCGCGCCTTGACAATTAATCATCCGGCTCTTAATATGTGTGGACGAGGGCTAGCGGTGTTTAGTTAGCATCC
>pos_control_apFAB345	ACCTGTAATTCCAAGCGTCTGCACGAATATTCAGTTAGTGGGTTACCGTTATTCGACCAGCGGATATTTTAATTTCGCTGATACAACATACAGTCGAATGAATGGCTACAACATCGAAACTCGAGGGCGCGCCTTGACAATTAATCATCCGGCTCGTAGAGTATGTGGAGTATCGCTAGCGGTGTTTAGTTAGCATCC
>pos_control_PLTETo1	ACCTGTAATTCCAAGCGTCTGCACGAATATTCAGTTAGTGGGTTACCGTTATTCGACCAGCGGATATTTTAATTTCGCTGATACAACATACAGCTCGAGGGCGCGCCTCCCTATCAGTGATAGAGATTGACATCCCTATCAGTGATAGAGATACTGAGCACATCAGCAGTAATTGCTAGCGGTGTTTAGTTAGCATCC
>pos_control_pLlacO1	GGATGCTAACTAAACACCGCTAGCGCAATGCTGATGTGCTCAGTATCTTGTTATCCGCTCACAATGTCAATTGTTATCCGCTCACATTTATGGCGCGCCCTCGAGCTGTATGTTGTATCAGCGAAATTAAAATATCCGCTGGTCGAATAACGGTAACCCACTAACTGAATATTCGTGCAGACGCTTGGAATTACAGGT
>pos_control_apFAB124	ACCTGTAATTCCAAGCGTCTGCACGAATATTCAGTTAGTGGGTTACCGTTATTCGACCAGCGGATATTTTAATTTCGCTGATACAACATACAGTCGAATGAATGGCTACAACATCGAACTCGAGGGCGCGCCTCGACATTTATCCCTTGCGGCGAATACTTACAGCCATAGCAAGCTAGCGGTGTTTAGTTAGCATCC
>pos_control_apFAB125	ACCTGTAATTCCAAGCGTCTGCACGAATATTCAGTTAGTGGGTTACCGTTATTCGACCAGCGGATATTTTAATTTCGCTGATACAACATACAGTCGAATGAATGGCTACAACATCGAACTCGAGGGCGCGCCTCGACATTTATCCCTTGCGGCGATATAATGTGTGGATAATCCGCTAGCGGTGTTTAGTTAGCATCC
>pos_control_apFAB129	ACCTGTAATTCCAAGCGTCTGCACGAATATTCAGTTAGTGGGTTACCGTTATTCGACCAGCGGATATTTTAATTTCGCTGATACAACATACAGTCGAATGAATGGCTACCTCGAGGGCGCGCCCACGGTGTTAGACATAAAGTCTAACCTATAGGATACTTACAGCCATGCCGTGCTAGCGGTGTTTAGTTAGCATCC
>pos_control_apFAB68	ACCTGTAATTCCAAGCGTCTGCACGAATATTCAGTTAGTGGGTTACCGTTATTCGACCAGCGGATATTTTAATTTCGCTGATACAACATACAGTCGAATGAATGGCTACAACATCGAACTCGAGGGCGCGCCTTGACATCAGGAAAATTTTTCTGTAGATTTAACGTATAGGTAGCTAGCGGTGTTTAGTTAGCATCC
>pos_control_apFAB317	ACCTGTAATTCCAAGCGTCTGCACGAATATTCAGTTAGTGGGTTACCGTTATTCGACCAGCGGATATTTTAATTTCGCTGATACAACATACAGTCGAATGAATGGCTACAACATCGAAACTCGAGGGCGCGCCTTGATATTTAATCATCCGGCTCGTATAATGTGTGGAGCACCGCTAGCGGTGTTTAGTTAGCATCC
>pos_control_apFAB312	ACCTGTAATTCCAAGCGTCTGCACGAATATTCAGTTAGTGGGTTACCGTTATTCGACCAGCGGATATTTTAATTTCGCTGATACAACATACAGTCGAATGAATGGCTACAACATCGAAACTCGAGGGCGCGCCTTGACAATTAATCATCCGGCTCTTAGTGTTTGTGGAGCATTGCTAGCGGTGTTTAGTTAGCATCC
>pos_control_apFAB318	ACCTGTAATTCCAAGCGTCTGCACGAATATTCAGTTAGTGGGTTACCGTTATTCGACCAGCGGATATTTTAATTTCGCTGATACAACATACAGTCGAATGAATGGCTACAACATCGAAACTCGAGGGCGCGCCTTGACTATTAATCATCCGGCTCGTATAATGTGTGGATACACGCTAGCGGTGTTTAGTTAGCATCC
>pos_control_apFAB259	ACCTGTAATTCCAAGCGTCTGCACGAATATTCAGTTAGTGGGTTACCGTTATTCGACCAGCGGATATTTTAATTTCGCTGATACAACATACAGTCGAATGAATGGCTACAACATCGAAACTCGAGGGCGCGCCTTCACACTTAATCATCCGGCTCGTATAATGTGTGGACCGCAGCTAGCGGTGTTTAGTTAGCATCC
>pos_control_apFAB42	ACCTGTAATTCCAAGCGTCTGCACGAATATTCAGTTAGTGGGTTACCGTTATTCGACCAGCGGATATTTTAATTTCGCTGATACAACATACAGTCGAATGAATGGCTACTCGAGGGCGCGCCAAAAAGAGTATTGACTTCAGGAAAATTTTTCTGCATAATTATTTCATAGGCGGCTAGCGGTGTTTAGTTAGCATCC
>pos_control_lacUV5	ACCTGTAATTCCAAGCGTCTGCACGAATATTCAGTTAGTGGGTTACCGTTATTCGACCAGCGGATATTTTAATTTCGCTGATACAACATACAGTCGAATGAACTCGAGGGCGCGCCCCCCAGGCTTTACACTTTATGCTTCCGGCTCGTATAATGTGTGGAATTGTGAGTTGGTGCTAGCGGTGTTTAGTTAGCATCC
>pos_control_pT7A1	GGATGCTAACTAAACACCGCTAGCCGCAGCTCTCGATGGCTGTAAGTATCCTATAGGTTAGACTTTAAGTCAATACTCTTTTTGAGGCGCGCCCTCGAGATTCGACTGTATGTTGTATCAGCGAAATTAAAATATCCGCTGGTCGAATAACGGTAACCCACTAACTGAATATTCGTGCAGACGCTTGGAATTACAGGT
>pos_control_BBa_J23100	ACCTGTAATTCCAAGCGTCTGCACGAATATTCAGTTAGTGGGTTACCGTTATTCGACCAGCGGATATTTTAATTTCGCTGATACAACATACAGTCGAATGAATGGCTACAACATCGAAACCTCGAGGGCGCGCCTTGACGGCTAGCTCAGTCCTAGGTACAGTGCTAGCTTAATGCTAGCGGTGTTTAGTTAGCATCC
>pos_control_BBa_J23103	ACCTGTAATTCCAAGCGTCTGCACGAATATTCAGTTAGTGGGTTACCGTTATTCGACCAGCGGATATTTTAATTTCGCTGATACAACATACAGTCGAATGAATGGCTACAACATCGAAACCTCGAGGGCGCGCCCTGATAGCTAGCTCAGTCCTAGGGATTATGCTAGCAGATGGCTAGCGGTGTTTAGTTAGCATCC
>pos_control_BBa_J23102	ACCTGTAATTCCAAGCGTCTGCACGAATATTCAGTTAGTGGGTTACCGTTATTCGACCAGCGGATATTTTAATTTCGCTGATACAACATACAGTCGAATGAATGGCTACAACATCGAAACCTCGAGGGCGCGCCTTGACAGCTAGCTCAGTCCTAGGTACTGTGCTAGCAACCTGCTAGCGGTGTTTAGTTAGCATCC
>pos_control_apFAB79	ACCTGTAATTCCAAGCGTCTGCACGAATATTCAGTTAGTGGGTTACCGTTATTCGACCAGCGGATATTTTAATTTCGCTGATACAACATACAGTCGAATGAATGGCCTCGAGGGCGCGCCAAAAAATTTATTTGCTTTAAAGTCTAACCTATAGGATACTTACAGCCATAGTCTGCTAGCGGTGTTTAGTTAGCATCC
>pos_control_apFAB78	ACCTGTAATTCCAAGCGTCTGCACGAATATTCAGTTAGTGGGTTACCGTTATTCGACCAGCGGATATTTTAATTTCGCTGATACAACATACAGTCGAATGAATGGCTACAACATCGAACTCGAGGGCGCGCCTTGACATTTATCCCTTGCGGCGATAGATTTAACGTATGACGGGCTAGCGGTGTTTAGTTAGCATCC
>pos_control_BBa_J23107	ACCTGTAATTCCAAGCGTCTGCACGAATATTCAGTTAGTGGGTTACCGTTATTCGACCAGCGGATATTTTAATTTCGCTGATACAACATACAGTCGAATGAATGGCTACAACATCGAAACCTCGAGGGCGCGCCTTTACGGCTAGCTCAGCCCTAGGTATTATGCTAGCATGGAGCTAGCGGTGTTTAGTTAGCATCC
>pos_control_apFAB75	ACCTGTAATTCCAAGCGTCTGCACGAATATTCAGTTAGTGGGTTACCGTTATTCGACCAGCGGATATTTTAATTTCGCTGATACAACATACAGTCGAATGAATGGCTACAACATCGAACTCGAGGGCGCGCCTTGACATTTATCCCTTGCGGCGATATAATGTGTGGATAAGTGGCTAGCGGTGTTTAGTTAGCATCC
>pos_control_apFAB77	ACCTGTAATTCCAAGCGTCTGCACGAATATTCAGTTAGTGGGTTACCGTTATTCGACCAGCGGATATTTTAATTTCGCTGATACAACATACAGTCGAATGAATGGCTACAACATCGAACTCGAGGGCGCGCCTTGACATTTATCCCTTGCGGCGACATAATTATTTCATTTTGGGCTAGCGGTGTTTAGTTAGCATCC
>pos_control_apFAB76	ACCTGTAATTCCAAGCGTCTGCACGAATATTCAGTTAGTGGGTTACCGTTATTCGACCAGCGGATATTTTAATTTCGCTGATACAACATACAGTCGAATGAATGGCTACAACATCGAACTCGAGGGCGCGCCTTGACATTTATCCCTTGCGGCGATATAATAGATTCATTCCGGGCTAGCGGTGTTTAGTTAGCATCC
>pos_control_apFAB70	ACCTGTAATTCCAAGCGTCTGCACGAATATTCAGTTAGTGGGTTACCGTTATTCGACCAGCGGATATTTTAATTTCGCTGATACAACATACAGTCGAATGAATGGCTACAACATCGAACTCGAGGGCGCGCCTTGACATCGCATCTTTTTGTACCTATAATGTGTGGATAGAGTGCTAGCGGTGTTTAGTTAGCATCC
>pos_control_apFAB73	ACCTGTAATTCCAAGCGTCTGCACGAATATTCAGTTAGTGGGTTACCGTTATTCGACCAGCGGATATTTTAATTTCGCTGATACAACATACAGTCGAATGAATGGCTACAACATCGAACTCGAGGGCGCGCCTTGACATCGCATCTTTTTGTACCTAGATTTAACGTATTCGGCGCTAGCGGTGTTTAGTTAGCATCC
>pos_control_apFAB72	ACCTGTAATTCCAAGCGTCTGCACGAATATTCAGTTAGTGGGTTACCGTTATTCGACCAGCGGATATTTTAATTTCGCTGATACAACATACAGTCGAATGAATGGCTACAACATCGAACTCGAGGGCGCGCCTTGACATCGCATCTTTTTGTACCCATAATTATTTCATGCGTCGCTAGCGGTGTTTAGTTAGCATCC
>pos_control_galP1	ACCTGTAATTCCAAGCGTCTGCACGAATATTCAGTTAGTGGGTTACCGTTATTCGACCAGCGGATATTTTAATTTCGCTGATACAACATACAGTCGACTCGAGGGCGCGCCTTTATTCCATGTCACACTTTTCGCATCTTTGTTATGCTATGGTTATTTCATACCATAATTCGAGCTAGCGGTGTTTAGTTAGCATCC
>pos_control_apFAB311	ACCTGTAATTCCAAGCGTCTGCACGAATATTCAGTTAGTGGGTTACCGTTATTCGACCAGCGGATATTTTAATTTCGCTGATACAACATACAGTCGAATGAATGGCTACAACATCGAAACTCGAGGGCGCGCCTTGACAATTAATCATCCGGCTCGTAGGTTGTGTGGACGGCTGCTAGCGGTGTTTAGTTAGCATCC
>pos_control_J23101	ACCTGTAATTCCAAGCGTCTGCACGAATATTCAGTTAGTGGGTTACCGTTATTCGACCAGCGGATATTTTAATTTCGCTGATACAACATACAGTCGAATGAATGGCTACAACATCGAAACCTCGAGGGCGCGCCTTTACAGCTAGCTCAGTCCTAGGTATTATGCTAGCCAGTTGCTAGCGGTGTTTAGTTAGCATCC
>pos_control_apFAB321	ACCTGTAATTCCAAGCGTCTGCACGAATATTCAGTTAGTGGGTTACCGTTATTCGACCAGCGGATATTTTAATTTCGCTGATACAACATACAGTCGAATGAATGGCTACAACATCGAAACTCGAGGGCGCGCCTTGACAATTAATCATCCGGCTCGTAACTTATGTGGACTCGGGCTAGCGGTGTTTAGTTAGCATCC
>pos_control_apFAB322	ACCTGTAATTCCAAGCGTCTGCACGAATATTCAGTTAGTGGGTTACCGTTATTCGACCAGCGGATATTTTAATTTCGCTGATACAACATACAGTCGAATGAATGGCTACAACATCGAAACTCGAGGGCGCGCCTTGCGTATTAATCATCCGGCTCGTATAATGTGTGGATGATCGCTAGCGGTGTTTAGTTAGCATCC
>pos_control_apFAB323	ACCTGTAATTCCAAGCGTCTGCACGAATATTCAGTTAGTGGGTTACCGTTATTCGACCAGCGGATATTTTAATTTCGCTGATACAACATACAGTCGAATGAATGGCTACAACATCGAAACTCGAGGGCGCGCCTTGTATTTTAATCATCCGGCTCGTATAATGTGTGGAATCCAGCTAGCGGTGTTTAGTTAGCATCC
>pos_control_apFAB71	ACCTGTAATTCCAAGCGTCTGCACGAATATTCAGTTAGTGGGTTACCGTTATTCGACCAGCGGATATTTTAATTTCGCTGATACAACATACAGTCGAATGAATGGCTACAACATCGAACTCGAGGGCGCGCCTTGACATCGCATCTTTTTGTACCTATAATAGATTCATGATGAGCTAGCGGTGTTTAGTTAGCATCC
>pos_control_apFAB130	ACCTGTAATTCCAAGCGTCTGCACGAATATTCAGTTAGTGGGTTACCGTTATTCGACCAGCGGATATTTTAATTTCGCTGATACAACATACAGTCGAATGAATGGCTACCTCGAGGGCGCGCCCACGGTGTTAGACATAAAGTCTAACCTATAGGTATAATGTGTGGATCCGTGGCTAGCGGTGTTTAGTTAGCATCC
>pos_control_apFAB134	ACCTGTAATTCCAAGCGTCTGCACGAATATTCAGTTAGTGGGTTACCGTTATTCGACCAGCGGATATTTTAATTTCGCTGATACAACATACAGTCGAATGAATGGCTACACTCGAGGGCGCGCCCACGGTGTTAGACAATTAATCATCCGGCTCGATACTTACAGCCATGATTCGCTAGCGGTGTTTAGTTAGCATCC
>pos_control_apFAB139	ACCTGTAATTCCAAGCGTCTGCACGAATATTCAGTTAGTGGGTTACCGTTATTCGACCAGCGGATATTTTAATTTCGCTGATACAACATACAGTCGAATGAATGGCTACACTCGAGGGCGCGCCCACGGTGTTAGACATCAGGAAAATTTTTCTGATACTTACAGCCATCGACCGCTAGCGGTGTTTAGTTAGCATCC
>pos_control_apFAB38	ACCTGTAATTCCAAGCGTCTGCACGAATATTCAGTTAGTGGGTTACCGTTATTCGACCAGCGGATATTTTAATTTCGCTGATACAACATACAGTCGAATGAATGGCTACTCGAGGGCGCGCCAAAAAGAGTATTGACTATTAATCATCCGGCTCGTAGATTTAACGTATCGGTCGCTAGCGGTGTTTAGTTAGCATCC
>pos_control_apFAB31	GGATGCTAACTAAACACCGCTAGCGCCCTATGAATCTATTATACCTATAGGTTAGACTTTAAGTCAATACTCTTTTTGGCGCGCCCTCGAGAGCCATTCATTCGACTGTATGTTGTATCAGCGAAATTAAAATATCCGCTGGTCGAATAACGGTAACCCACTAACTGAATATTCGTGCAGACGCTTGGAATTACAGGT
>pos_control_apFAB30	ACCTGTAATTCCAAGCGTCTGCACGAATATTCAGTTAGTGGGTTACCGTTATTCGACCAGCGGATATTTTAATTTCGCTGATACAACATACAGTCGAATGAATGGCTCTCGAGGGCGCGCCAAAAAGAGTATTGACTTAAAGTCTAACCTATAGGTATAATGTGTGGATCATTGGCTAGCGGTGTTTAGTTAGCATCC
>pos_control_apFAB33	ACCTGTAATTCCAAGCGTCTGCACGAATATTCAGTTAGTGGGTTACCGTTATTCGACCAGCGGATATTTTAATTTCGCTGATACAACATACAGTCGAATGAATGGCTCTCGAGGGCGCGCCAAAAAGAGTATTGACTTAAAGTCTAACCTATAGGTAGATTTAACGTATCTGATGCTAGCGGTGTTTAGTTAGCATCC
>pos_control_apFAB32	ACCTGTAATTCCAAGCGTCTGCACGAATATTCAGTTAGTGGGTTACCGTTATTCGACCAGCGGATATTTTAATTTCGCTGATACAACATACAGTCGAATGAATGGCTCTCGAGGGCGCGCCAAAAAGAGTATTGACTTAAAGTCTAACCTATAGGCATAATTATTTCATCACTAGCTAGCGGTGTTTAGTTAGCATCC
>pos_control_apFAB36	ACCTGTAATTCCAAGCGTCTGCACGAATATTCAGTTAGTGGGTTACCGTTATTCGACCAGCGGATATTTTAATTTCGCTGATACAACATACAGTCGAATGAATGGCTACTCGAGGGCGCGCCAAAAAGAGTATTGACTATTAATCATCCGGCTCGTATAATAGATTCATTGAAGGCTAGCGGTGTTTAGTTAGCATCC
>pos_control_apFAB140	ACCTGTAATTCCAAGCGTCTGCACGAATATTCAGTTAGTGGGTTACCGTTATTCGACCAGCGGATATTTTAATTTCGCTGATACAACATACAGTCGAATGAATGGCTACACTCGAGGGCGCGCCCACGGTGTTAGACATCAGGAAAATTTTTCTGTATAATGTGTGGATGCTTAGCTAGCGGTGTTTAGTTAGCATCC
>pos_control_apFAB149	ACCTGTAATTCCAAGCGTCTGCACGAATATTCAGTTAGTGGGTTACCGTTATTCGACCAGCGGATATTTTAATTTCGCTGATACAACATACAGTCGAATGAATGGCTACACTCGAGGGCGCGCCCACGGTGTTAGACATTTATCCCTTGCGGCGAATACTTACAGCCATGTGAAGCTAGCGGTGTTTAGTTAGCATCC
>pos_control_Nopromoter	GGATGCTAACTAAACACCGCTAGCCATTCCGGATGATTAATGGCGCGCCCTCGAGTAACCTGAATAACTCCGTCCTGTGTTTCGATGTTGTAGCCATTCATTCGACTGTATGTTGTATCAGCGAAATTAAAATATCCGCTGGTCGAATAACGGTAACCCACTAACTGAATATTCGTGCAGACGCTTGGAATTACAGGT
>pos_control_BBa_J23104	ACCTGTAATTCCAAGCGTCTGCACGAATATTCAGTTAGTGGGTTACCGTTATTCGACCAGCGGATATTTTAATTTCGCTGATACAACATACAGTCGAATGAATGGCTACAACATCGAAACCTCGAGGGCGCGCCTTGACAGCTAGCTCAGTCCTAGGTATTGTGCTAGCTTACGGCTAGCGGTGTTTAGTTAGCATCC
>pos_control_apFAB342	GGATGCTAACTAAACACCGCTAGCTCGCCTCCACAAATTTTATGAGCCGGATGATTAATTGTCAAGGCGCGCCCTCGAGTTTCGATGTTGTAGCCATTCATTCGACTGTATGTTGTATCAGCGAAATTAAAATATCCGCTGGTCGAATAACGGTAACCCACTAACTGAATATTCGTGCAGACGCTTGGAATTACAGGT
>pos_control_BBa_J23106	ACCTGTAATTCCAAGCGTCTGCACGAATATTCAGTTAGTGGGTTACCGTTATTCGACCAGCGGATATTTTAATTTCGCTGATACAACATACAGTCGAATGAATGGCTACAACATCGAAACCTCGAGGGCGCGCCTTTACGGCTAGCTCAGTCCTAGGTATAGTGCTAGCGATAGGCTAGCGGTGTTTAGTTAGCATCC
>pos_control_apFAB39	ACCTGTAATTCCAAGCGTCTGCACGAATATTCAGTTAGTGGGTTACCGTTATTCGACCAGCGGATATTTTAATTTCGCTGATACAACATACAGTCGAATGAATGGCTACTCGAGGGCGCGCCAAAAAGAGTATTGACTTCAGGAAAATTTTTCTGATACTTACAGCCATTCCAAGCTAGCGGTGTTTAGTTAGCATCC
>pos_control_pTrc*	ACCTGTAATTCCAAGCGTCTGCACGAATATTCAGTTAGTGGGTTACCGTTATTCGACCAGCGGATATTTTAATTTCGCTGATACAACATACAGTCGAATGAATGGCTACAACTCGAGGGCGCGCCTTGACAATTAATCATCCGGCTCGTATAATGTGTGGAATTGTGAGATGAGGCTAGCGGTGTTTAGTTAGCATCC
>pos_control_apFAB50	ACCTGTAATTCCAAGCGTCTGCACGAATATTCAGTTAGTGGGTTACCGTTATTCGACCAGCGGATATTTTAATTTCGCTGATACAACATACAGTCGAATGAATGGCTACTCGAGGGCGCGCCAAAAAGAGTATTGACTTTTATCCCTTGCGGCGATATAATGTGTGGATTAACCGCTAGCGGTGTTTAGTTAGCATCC
>pos_control_apFAB109	ACCTGTAATTCCAAGCGTCTGCACGAATATTCAGTTAGTGGGTTACCGTTATTCGACCAGCGGATATTTTAATTTCGCTGATACAACATACAGTCGAATGAATGGCTACAACATCGAACTCGAGGGCGCGCCTCGACAATTAATCATCCGGCTCGATACTTACAGCCATCGATTGCTAGCGGTGTTTAGTTAGCATCC
>pos_control_apFAB100	ACCTGTAATTCCAAGCGTCTGCACGAATATTCAGTTAGTGGGTTACCGTTATTCGACCAGCGGATATTTTAATTTCGCTGATACAACATACAGTCGAATGAATGGCTCTCGAGGGCGCGCCAAAAAATTTATTTGCTTTTTATCCCTTGCGGCGATATAATGTGTGGATAGAACGCTAGCGGTGTTTAGTTAGCATCC
>pos_control_apFAB101	ACCTGTAATTCCAAGCGTCTGCACGAATATTCAGTTAGTGGGTTACCGTTATTCGACCAGCGGATATTTTAATTTCGCTGATACAACATACAGTCGAATGAATGGCTCTCGAGGGCGCGCCAAAAAATTTATTTGCTTTTTATCCCTTGCGGCGATATAATAGATTCATCTTAGGCTAGCGGTGTTTAGTTAGCATCC
>pos_control_apFAB103	ACCTGTAATTCCAAGCGTCTGCACGAATATTCAGTTAGTGGGTTACCGTTATTCGACCAGCGGATATTTTAATTTCGCTGATACAACATACAGTCGAATGAATGGCTCTCGAGGGCGCGCCAAAAAATTTATTTGCTTTTTATCCCTTGCGGCGATAGATTTAACGTATCACGCGCTAGCGGTGTTTAGTTAGCATCC
>pos_control_apFAB104	GGATGCTAACTAAACACCGCTAGCAAGCTATGGCTGTAAGTATCCTATAGGTTAGACTTTATGTCGAGGCGCGCCCTCGAGTCGATGTTGTAGCCATTCATTCGACTGTATGTTGTATCAGCGAAATTAAAATATCCGCTGGTCGAATAACGGTAACCCACTAACTGAATATTCGTGCAGACGCTTGGAATTACAGGT
>neg_control_1395746:1395896	GGATGCTAACTAAACACCGCTAGCGAAGAGGTGATTCCTGATTTGGCGGAGCACTTACAGGCGGGGATTGTGGTTCTGGGCACGGTAGGACGCACCGGTATTTCAGCAGCATTCCTCGGCAACACGGCGGAACAGGTGATTGATCATCTTCGCTGCGACCTGCTGGTCATTAAACTCGAGACGCTTGGAATTACAGGT
>neg_control_2526567:2526717	ACCTGTAATTCCAAGCGTCTCGAGTCAATCGAAGCGGCTTCCAGCGCTTCCAGCGTGCCGAAATATGCCGCCAGACCTGCTGCGGTGGCCTCGCCGACTTCACGGATGCCAAGTGCATAGAGGAAGCGAGCAAAGGTGGTTTCTTTCGCTTTTTCCAGCGCGTTAACCACGTTTGCTAGCGGTGTTTAGTTAGCATCC
>neg_control_3595044:3595194	ACCTGTAATTCCAAGCGTCTCGAGGAACGCGCCAGCCCTTCGCCATACTGTTGTTTGTCGTGAATGATGGCGATGCGCTGGGGCTTCACCGTCTCAAGAATGTATTTTGCCGCCGTTGGCCCCTGGGAAGAGTCCAGCCCGGCAGTACGCATAATGTGTTGATAACCGCGTTGGGCTAGCGGTGTTTAGTTAGCATCC
>neg_control_2268257:2268407	ACCTGTAATTCCAAGCGTCTCGAGCAGCACTAAAAAAGGTATCGATTGTTCTGGTTTCGTACAGCGTACATTCCGTGAGCAATTTGGCTTAGAACTTCCGCGTTCGACTTACGAACAGCAGGAAATGGGTAAATCTGTTTCCCGCAGTAATTTGCGTACGGGTGATTTAGTTCTGCTAGCGGTGTTTAGTTAGCATCC
>neg_control_638566:638716	GGATGCTAACTAAACACCGCTAGCCAGGTCCAGAGACGGAGCCAGAGTTGCTTCACCTTCTTTCCATTTAGCCGGGCAAACTTCACCTGGGTGAGAAGCTACGTACTGTGCTGCTTTGATTTTACGCAGCAGGTCAGACGCGTCACGGCCAATGCCTTCAGCGGTAACTTCGATCTCGAGACGCTTGGAATTACAGGT
>neg_control_3543113:3543263	ACCTGTAATTCCAAGCGTCTCGAGGCGCCGCCGTTAAGTCCGCTTATCCACCAGCTTAAATTTTCCCGGCGCAGTGAAATCGCCAGCGCCCTGTCACGTCTGTTACTATTGGAAGTCTTACACGCTCGTCGCACCACCGGGTTGCAATTGCCGGATCGCATCGTCAGCGTTCCGGCTAGCGGTGTTTAGTTAGCATCC
>neg_control_674928:675078	ACCTGTAATTCCAAGCGTCTCGAGTTATACCAGGCAGTGGCGTCATTGCATTCAGCGGCTTTCGTAAACCATTCAAAGGCAGCCTGATAATCTTTCTCAACGCCTTGTCCGTGTTTATACATATAACCGATGTTGACGTAAGCGCCGACGCTCCCCTGAGCGGCAGCCTTCAGAGCTAGCGGTGTTTAGTTAGCATCC
>neg_control_1997776:1997926	ACCTGTAATTCCAAGCGTCTCGAGCGTATCGTTGGTTTTCTTCACCAGATCCAGCGCCGCCAGACGATCAACGAGGATCGCATCGATACGCCCTACGCGCAGATCCTGATATTTGGTCGGGTCATCATCATAGGTACGCACATCGACGCCCTGAACATTCTGCCGCAGCCACTCGCTAGCGGTGTTTAGTTAGCATCC
>neg_control_2560681:2560831	GGATGCTAACTAAACACCGCTAGCCTTTCATGTTCCAGTGCTTCGCATATTCTGGATGCACCGGCTTAACGCGTGTCATTACCAGGCAGTCGTCACGAACACCAATTTCCCAGCACTCCGTGTAATCGAAGGTCATGCCGATACCGAACGGGCTGGATGTGTCTGTGTAGACAACTCGAGACGCTTGGAATTACAGGT
>neg_control_1685523:1685673	ACCTGTAATTCCAAGCGTCTCGAGTATTTACCACCAAACTGCGCACCCAGACCAAGATTTTGCGCTTCGATCAGCAATTCTTTTTCCAGTTCCACATCGCGGAACGCCTGACCGTGCTCATTCCCTTCCGTTGGCAGTTCATCATAGTATTTCGCGGAAGCCAGTTTCACCGTTGCTAGCGGTGTTTAGTTAGCATCC
>neg_control_1489145:1489295	ACCTGTAATTCCAAGCGTCTCGAGAGCCAAAACCGATGATGACGGGACTGGCGCATTTGGGACATTTGGTGATTTATCTCCTGTTTATTGCGCTGCCAGTGATTGGTTTGGTGATGATGTATAACCGGGGCAACCCGTGGTTTGCGTTTGGTTTGACGATGCCTTACGCTTCAGGCTAGCGGTGTTTAGTTAGCATCC
>neg_control_1394523:1394673	GGATGCTAACTAAACACCGCTAGCGGGCCTTCATGCCAAAGTGCCACTGATTGCCTTTCTTGGTCTGATGCATCTCCGGATCGCGTTGCTGCTCTTTGTTCTTGGTCGAGCTGGGTGCCTCAATGATGGTGGCATCGACCAAGGTGCCTTGAGTCATCATGACGCCTGCTTCGGCTCGAGACGCTTGGAATTACAGGT
>neg_control_3152414:3152564	ACCTGTAATTCCAAGCGTCTCGAGTGCCGTCATGGATGATCATCATCCGCGCCTTATGCAGACGGTAATTCTTCAAATACTGCAACGGCGAGGTACTGGTGACAGACTTAAAATTATGGTGGAACGCCGATACGCTCATGTTGGCTTCTGCCGCCAGTTGCTCGACGCTCAGGTGCTAGCGGTGTTTAGTTAGCATCC
>neg_control_2261049:2261199	ACCTGTAATTCCAAGCGTCTCGAGTGTCAGCATTTCGTTGTCGAGCTTCAGCTGCTCACTCTGCTTTTCGCCCATCAGTAATGCGCGAAGTTCTTCTGCTGTTGTTGCTGACTTCAGTTGTTCAGCAACGGAATCATCGCTCAGTACGTGGGTCAGCTGGCGTAGCAGGCCCAGGCTAGCGGTGTTTAGTTAGCATCC
>neg_control_4571432:4571582	ACCTGTAATTCCAAGCGTCTCGAGCAGGCAACAGTTCGATTACGTAAAAGCGAAGTGAGATTTGGCAGGCAAAATCCATCGGCAGGTTTGTCGTTAGTGGCTCGTGCTGGAGGGATGATTGTTGGGAGCATTAAACTTGATGACAGTGAAATTGCCATTGGTGAGGTGCCGTTAGCTAGCGGTGTTTAGTTAGCATCC
>neg_control_2688601:2688751	ACCTGTAATTCCAAGCGTCTCGAGTTGCCCACGTTCGGCGATTTCACGCTGAAGCTGCTGCCCACGAGAGAACACCACTGTGCGCGTGGCCTGTACCATTTCGGTATTGGCACTGGCAAAGGCTTCAAGACGTGCGGCGGCGGCAGCATCGGGACCGCTGTTGTTACACTGAAGGCTAGCGGTGTTTAGTTAGCATCC
>neg_control_3960207:3960357	GGATGCTAACTAAACACCGCTAGCTGCACCTGATCCAGCTCTTCTTCACTCTCACCACGCTCCATCATGTCGCGCAAAGTAAAGCGCGTCACCACCTGGGTGAGCGTCATCGGCTCATCCAGTTCACTGCCTTCCAGCATCTCCGTCATCCAGCTAAACAGTTGGTTGACGTTCCTCGAGACGCTTGGAATTACAGGT
>neg_control_4167237:4167387	GGATGCTAACTAAACACCGCTAGCAGTTAGTGTTACCCAACCTTCAACCTGCCCATGGCTAGATCACCGGGTTTCGGGTCTATACCCTGCAACTTAACGCCCAGTTAAGACTCGGTTTCCCTTCGGCTCCCCTATTCGGTTAACCTTGCTACAGAATATAAGTCGCTGACCCATCTCGAGACGCTTGGAATTACAGGT
>neg_control_3954497:3954647	ACCTGTAATTCCAAGCGTCTCGAGGTGTGCGCCTGAGCCGCGGCCTCGAAGAGCGCAAAGAAATTTTGCAGATGCTCAACGACGGCGGCTACAGCGTGGTTGATCTCTCCGACGACGAAATGGCGAAGCTACACGTGCGCTATATGGTCGGCGGACGTCCATCGCATCCGTTGCGCTAGCGGTGTTTAGTTAGCATCC
>neg_control_4065615:4065765	ACCTGTAATTCCAAGCGTCTCGAGTCATACGGGCGAAATGGGCGATGGTTTCTGCGTCGCCGTCAAACTGCCAGTTGTCGCCAGGACGGTTACCTTCGTGGGTGCGCATCATCGGCGTGAAGGCGCTGAAATCGCACCAGCGCAGCAGCAGCTCTTTGCTGCGCTTCATCTCAAGCTAGCGGTGTTTAGTTAGCATCC
>neg_control_3588287:3588437	GGATGCTAACTAAACACCGCTAGCATGGAAGCAAATCAGCTACAACTTCCTGTTCTTCTATGCCGCGCTGCAATCCATTCCCCGTTCGTTGATCGAAGCCGCAGCCATCGACGGTGCAGGGCCGATTCGCCGCTTCTTTAAGATTGCGCTGCCGCTTATCGCCCCGGTGAGTTTCTCGAGACGCTTGGAATTACAGGT
>neg_control_3513533:3513683	GGATGCTAACTAAACACCGCTAGCACAAATTGCGCCGAGGTTTACTATCAGTTCCGCGAAGAGTTCAACAAAAGCCAGGATCCGTTCCGTCGGGCGGTACTGTTTTTATATTTGAACCGCTACGGTTACAACGGCCTGTGTCGTTACAATCTGCGCGGTGAGTTTAACGTGCCGCTCGAGACGCTTGGAATTACAGGT
>neg_control_111405:111555	ACCTGTAATTCCAAGCGTCTCGAGGGTAATTGCGAAGCTTAAACGTCTGTAGGTCAGATAAGGCGTTTTCGCCGCATCCGACATTCGCACACGATGCCTGATGCGACGCTGGCGCGTCTTATCAGGCCTAAAGGGATTTCTAACTCATTGATAAATTTGTTTTTGTAGGTCGGAGCTAGCGGTGTTTAGTTAGCATCC
>neg_control_1830757:1830907	GGATGCTAACTAAACACCGCTAGCCATATCGCCCATAATCAGTACCGGATTATCACGTTTGAGTTCGGTTTCCAGGTAGTTTTGCAGATTCTGATAAAACTGCGCTTTTGCCGGGAATTTTATCGGATGGTCGCGGCTTTCACCCTGCGGGAAGTAACCGTTGATCACGGTGACCTCGAGACGCTTGGAATTACAGGT
>neg_control_2778976:2779126	ACCTGTAATTCCAAGCGTCTCGAGGAACCAGTGACGACTGTTAATGAGCCAGCGTTTTCCAGCACTACATTTTTAGCTTCTGAATTCCTGATGTAGAAAGCATCACCATAACTGTTGGTTCCTTCGATAAGTGTTCCGGAGGTCGTGGAAGCAATTAATGCGCCGCCGGATTGTGCTAGCGGTGTTTAGTTAGCATCC
>neg_control_3648798:3648948	ACCTGTAATTCCAAGCGTCTCGAGGTTATTTGTAGGCCTGACAGGCGTAGCGCATCAGGCGATTTTGCTATTTACACAGTACTCCCTGCGTGAGATTCCAATTATCGCGTCCAGCATGGTGTATCAGTGAGCTGCTTAGTTATCAGCGATACAGCGCAGTAGTTTAAAGACGTAGCTAGCGGTGTTTAGTTAGCATCC
>neg_control_1389225:1389375	ACCTGTAATTCCAAGCGTCTCGAGCCGGTGCTGTTGGATACTGCGCGCGAGGGGTGTGGTAATACTCCCAGGCCTGACGCAGTTCTTCGTTCGGCGCATCGGACTCCTTCATTGGTGCCAGTGGCATAATGGCGTATTCTCCGCTGCTAATATCGCTGGTTCTGGCGTTTGAACGCTAGCGGTGTTTAGTTAGCATCC
>neg_control_719206:719356	GGATGCTAACTAAACACCGCTAGCCCTTTCTTCCGCGCACTGGTCGATTATGTCAATCAAGGTAACAGCGCGTTTGATTGCCCTGGTCATCAGGGCGGCGAATTTTTCCGTCGCCATCCGGCGGGGAATCAGTTTGTGGAATACTTTGGTGAGGCGCTGTTCCGTGCCGACTTGCTCGAGACGCTTGGAATTACAGGT
>neg_control_1153323:1153473	ACCTGTAATTCCAAGCGTCTCGAGCCGAATTAGTCATGAAAAAAGTGTTATTGATAATCTTGTTATTGCTGGTGGTACTGGGTATCGCCGCTGGTGTGGGCGTCTGGAAGGTTCGCCATCTTGCCGACAGCAAATTGCTTATCAAAGAAGAGACGATATTTACCCTGAAGCCAGGCTAGCGGTGTTTAGTTAGCATCC
>neg_control_3784165:3784315	GGATGCTAACTAAACACCGCTAGCTGAAGAAGAAAGTAACGTGGGCATATTTTTCGGTTTCGGAAATACGCAACTGAGTTTTGTCGTTTTTCGCCATCCACTCGCCGAAGGTGTTAACCAGGGAAGCGGGTGGGTAAGCAACCGCAGTTTTGATGTCAGCGGCGTATTCGGTCACTCGAGACGCTTGGAATTACAGGT
>neg_control_36874:37024	GGATGCTAACTAAACACCGCTAGCATGTATTCCGATGATGATCCGTACGTTGATGGTACAGCCGCCTTCAGCGAACGATCAGCAACACCGCCTGCGGGAAGTGATGTTTTATCTCAACTTGTCGGAGCAGGAAAAAGATGCGTTTTGTGAACGCTTCGGCGTTCGCTTGCTGACCTCGAGACGCTTGGAATTACAGGT
>neg_control_945627:945777	ACCTGTAATTCCAAGCGTCTCGAGCGTGTGCTGAATCAGCAGGCTGAAAACCATGATTCGACGTCAATTACGTCAATGCTAAAACTCCGTCAGGCGCGGCTTGGCGTGAATGGCTGCATTATCTCAGGAATCGTTCTGGGATCTCTATATGGCCTGATGCCGCTGTACCTCAATGCTAGCGGTGTTTAGTTAGCATCC
>neg_control_1071183:1071333	GGATGCTAACTAAACACCGCTAGCCCTTCGTTCCCGGCACGCTGGCTGATGGCGTGGTGTATGTCTCCGGTACGCTGGCTTTTGATCAACATAATAACGTGCTGTTTGCCGATGACCCAAAGGCGCAAACCCGCCACGTTCTGGAAACTATCCGCAAGGTGATCGAGACGGCGGCTCGAGACGCTTGGAATTACAGGT
>neg_control_3877800:3877950	ACCTGTAATTCCAAGCGTCTCGAGACCGCCGGACACTTTATAGGAGTTATCGTCAAATTTACCGCCTGCGTGCAGAACGGTCATGATCACTTCCGCCGCCGATACGCCCTCTTCCGGGTGAATACCGGTCGGAATGCCGCGCCCGTCATCCTGTACAGAGACAGAGTTATCGGCGCTAGCGGTGTTTAGTTAGCATCC
>neg_control_2224476:2224626	GGATGCTAACTAAACACCGCTAGCTGGCTTTGTTCGGAGGGCGCAAATTACACCACCGGGCAGTCGTTGATAGTGGATGGCGGCTTTATGTTGGCGAATCCACAGTTCAACCCAGAATAGCGCAGTGAGGTGCGTGGATATTTCATTGGGTAATATTTTGGTCGGCATGAAAAGCTCGAGACGCTTGGAATTACAGGT
>neg_control_3037199:3037349	GGATGCTAACTAAACACCGCTAGCTGAAGTGTTGTATGCTACCGGGCTGCGTGTCTCTGAACTGGTCGGACTGACAATGAGTGATATCAGCCTGCGTCAGGGCGTGGTACGGGTCATTGGTAAAGGCAACAAAGAGCGTCTGGTGCCGTTAGGTGAAGAGGCGGTTTACTGGCTCTCGAGACGCTTGGAATTACAGGT
>neg_control_2343567:2343717	ACCTGTAATTCCAAGCGTCTCGAGATCGAGTGCGGTGACAGCCTGGATTCCATCAACGCCACCTCCAGCGCGATTGTTAAATACGTTTCCCAGCGTGCCGGGATCGGCATCAACGCCGGGCGTATTCGTGCGCTGGGTAGCCCGATTCGCGGTGGTGAAGCGTTCCATACCGGCGCTAGCGGTGTTTAGTTAGCATCC
>neg_control_759135:759285	ACCTGTAATTCCAAGCGTCTCGAGGTTCTACGCCGTACTGTACTGATATCGGTAAGATGGTTCAGGCCCCGATTTTCCACGTTAACGCGGACGATCCGGAAGCCGTTGCCTTTGTGACCCGTCTGGCGCTCGATTTCCGTAACACCTTTAAACGTGATGTCTTCATCGACCTGGGCTAGCGGTGTTTAGTTAGCATCC
>neg_control_1925429:1925579	GGATGCTAACTAAACACCGCTAGCGTTCCGGTTTCGTTGGTCTACCATCGCAAACATTTTCGCAAAGGACACAACCCGTTGCTGGTGTATGGCTATGGTTCTTACGGCGCAAGTATTGATGCCGATTTCAGTTTTAGCCGCTTGAGTTTGTTAGATCGTGGCTTTGTCTACGCCCTCGAGACGCTTGGAATTACAGGT
>neg_control_3365212:3365362	GGATGCTAACTAAACACCGCTAGCCGGCATAACTACCGATATTTTTATTATCTTTTGTTTTCCCTAAGCCGAATAAGCGCGTTGTCTGGCTAATATAACCTCCGCCATTTAAGGTATATTTTACACCACTCTGACCCCCACTATCTTTTCCGGTGGTCATACTATCCATTCGTGCTCGAGACGCTTGGAATTACAGGT
>neg_control_1498943:1499093	ACCTGTAATTCCAAGCGTCTCGAGGTTGGCTTATGCCGCCTGGCAAACTGCGGGATTATGGCGCGGATCTCACCCTGAAGAAGCTACCACGCCTGGACTGTATCTGCCGACAGTTGCCAACAACTTTATCAGCGCAATGGCCTGTGGTGCGTTGGGCTACACCGACGCCGGTCTGCTAGCGGTGTTTAGTTAGCATCC
>neg_control_3720155:3720305	ACCTGTAATTCCAAGCGTCTCGAGAGACAAACAGTCTCAAGCACCCGTGGCTATTCTAGCTTAATAAGTTTGTTTCTTCTCCTTGATATAATCCTAAAAAAATCTCATAAAATTAATATATGAGATAATCTTTATTCAGCAGAAGATTATTAAAGGTTGCTGTATTATTTAGCGGCTAGCGGTGTTTAGTTAGCATCC
>neg_control_531826:531976	ACCTGTAATTCCAAGCGTCTCGAGTACGCTTATCAGCATTAACCGCGCGCAACCGGCGAATCTGCCGCTGACCATTCACGAACTCGAACGTCATCCGCTGGGTACTCAGGCCTTTATCCCGATGAAAGGTGAGGTGTTTGTGGTGGTCGTGGCGTTAGGTGACGACAAACCAGAGCTAGCGGTGTTTAGTTAGCATCC
>neg_control_2240338:2240488	GGATGCTAACTAAACACCGCTAGCATTTTGTATGAAAAATACTGGAAGCTTCACGGCGGCGTTGAAGCGATCAGTAATCGTGCCGATGGTGTTGGCAACAGTTTACTGGCACTGGGCGCACAGTATGGCTGGCAACTGGCAGGGATGATGCTCATTGGTGCGGCGCTGATGCGCCTCGAGACGCTTGGAATTACAGGT
>neg_control_1192411:1192561	ACCTGTAATTCCAAGCGTCTCGAGAGAGTCTTTTTTCTTCGCGGTGACCAGACCAAGATCTTCAGCAATCTTACGCACCTGCGGTTTTTCCAGTTCGCCGACCGGGAACAGGCTTTGCGCAATCTGCTCATGGCTGAGCGTATAAAGGAAGTAGCTCTGGTCTTTATTGCTGTCGCTAGCGGTGTTTAGTTAGCATCC
>neg_control_1768598:1768748	ACCTGTAATTCCAAGCGTCTCGAGTATTTATATTTTATTGTTTATTTCATGCAGCCATTACACGATGAACGCTTATGAACTCCAGGCACTCCGCCATATTTTTGCCATGACTATTGATGAATGCGCGACCTGGATTGCCCAGACCGGTGACAGTGAAAGCTGGCGTCAGTGGGAGCTAGCGGTGTTTAGTTAGCATCC
>neg_control_1890258:1890408	GGATGCTAACTAAACACCGCTAGCGCAACTCGGTGAGCCAGGTTATCGCGGTAACCTGCGTGAGCTGTTAGCTAATCCGCAAATTCAGCGGGCATTTTTACTGCTCGATGACACCCTGGAACTTTGTTATGACGTGGCGAAACTGTCACTGGGGCGTTCCGCCTTGCTGGATGCCTCGAGACGCTTGGAATTACAGGT
>neg_control_3838842:3838992	GGATGCTAACTAAACACCGCTAGCGCTGTTGAGTTTTGGTATCGCCAGCTTTATTGGTACGTCGCTTTCGTCGTTCATTCTTAAACGTTCGGTAAAACTGGCCTTAGCAGGCGCGCCGTTAATACTGGCTGTGAGTGCGTTGGTACTGACGTTGTGGGGAAGCGATAAAATCGTCTCGAGACGCTTGGAATTACAGGT
>neg_control_1769618:1769768	ACCTGTAATTCCAAGCGTCTCGAGTCTGTTTTTATACCGTTGTACGTTCCCACCCCATCCGGGTCGTCGCTTACCTGTCATAAAGAAAACCACCAGCTCTACGGAACATCGCTGTTCAATTATCGATTTAGCCAGTTATACCTTATATGGCTATATCTCAATGGCAACGTTTTAGCTAGCGGTGTTTAGTTAGCATCC
>neg_control_860583:860733	GGATGCTAACTAAACACCGCTAGCTCTCTTACGCGATCCTCGAATCCTGCGGTCGCCTGCGTTCCACTCAGCCTAACCTCAGCGTGCGTTACCATGCAGGAATGAGCAACGATTTCCTCGACGCCTGCGTACAGGTGATCCGTTGCGGCTTCGGGATGCCGGCGTTCAACAACGCTCGAGACGCTTGGAATTACAGGT
>neg_control_1183501:1183651	GGATGCTAACTAAACACCGCTAGCTCGGTTGGCTTGTGTTGTTTGTCTTTCTGCCCAACCTGATGATCATTGGCACCAGCTTTTTGACCCGCGACGACGCCAGTTTTGTCAAAATGGTCTTTACGCTGGATAACTACACGCGTCTGCTCGATCCGCTCTATTTTGAAGTGCTATCTCGAGACGCTTGGAATTACAGGT
>neg_control_910786:910936	GGATGCTAACTAAACACCGCTAGCCAACGTGCGTACGCCGCAGGATGTTATTTTCGCCGATGAGTGGCGTAACTATCCGGTAACGCTGGTGGCAGAAAATAACGTTACCGAAGGCTTTATCGCTGGTCGTCTCACTCGCGAACTGCTGGCAGGTGTACCTGACTTAGCTTCACGCTCGAGACGCTTGGAATTACAGGT
>neg_control_229929:230079	ACCTGTAATTCCAAGCGTCTCGAGGCCTGGTTAGCCCGGAAGGTCTGGCTCCTGAATGGGATTAAGCCTCTCTGACAGCTCCTCCGGGAGCTGTTTTTACATGCTCGCTAAGGAAATCGATAAAAGCCCGGATGCGCGTACTTACCGCACGGTCGCTGTAATAGACGGCACTGAGCTAGCGGTGTTTAGTTAGCATCC
>neg_control_338427:338577	ACCTGTAATTCCAAGCGTCTCGAGGCGGCGATGGATGCGGCGCATGGCATCGAATACAGCACCGTGGTCACCACCATGGCGCGTAACGGCGTCGAGTTCGGCCTGCGGGTCAGCGGCCTGCCGGGGCAATGGTTTACCGGCCCGGCGCAGCAGGTGATCGGCCCGATGTTTGCCGCTAGCGGTGTTTAGTTAGCATCC
>neg_control_891549:891699	ACCTGTAATTCCAAGCGTCTCGAGCATTCGCCGGATGATACCAGCGATTTAATCGACATGGTCGGTGGTGCGCCGCTGGTGGTCAAGTTGGTTGAAGGCACGCAGGGAATTGGCGTCGTGCTGGCGGAGACGCGTCAGGCGGCGGAAAGCGTGATTGACGCTTTCCGCGGTCTGGCTAGCGGTGTTTAGTTAGCATCC
>neg_control_1974213:1974363	ACCTGTAATTCCAAGCGTCTCGAGTGCTGCCCCGTGGCTTTTGGCTTTGCGTCGTTTGACGACAATAATCGGATGCGCTTGATTCTTCATGCTTCCTCGGTTGTCGTCTGTTGTTGCGGATTTTTCACCGCACGCACATGCTCTTCCAGTTCAATAAACGACGGACGTTCGCTGGCTAGCGGTGTTTAGTTAGCATCC
>neg_control_3197124:3197274	GGATGCTAACTAAACACCGCTAGCGCGTGACTGGCTGTATGACGCCTGCTGCCGCGAGTGGGGAACGCCGTGCAATGCGCAGGGCGAAGCGCAACCGCTGCTGATTTTAGGCATGGGTAAGCTGGGCGGTGGGGAGCTGAATTTCTCCTCTGATATCGATCTGATTTTTGCCTGCTCGAGACGCTTGGAATTACAGGT
>neg_control_1569051:1569201	GGATGCTAACTAAACACCGCTAGCGTGACGAAGAAGCGCTGCCGCAGGAACTGGTGTTCAACGTTGACTACCTGGGTGGTCAAATTGGTACTTTTGCCATCAACTTCTCCCGCCCGGCGGGTCAGGTAATTGCACAGTACTATGAATTCCTGCGCCTCGGTCGTGAAGGCTATACTCGAGACGCTTGGAATTACAGGT
>neg_control_1665912:1666062	GGATGCTAACTAAACACCGCTAGCTGCCGCTCGGCGAGGCGCTGGAGCAGCATACCGGCGTTCCGGTTTATATTCAGCATGATATCAGCGCATGGACGATGGCAGAGGCCTTGTTTGGTGCCTCACGCGGGGCGCGCGATGTGATTCAGGTGGTTATCGATCACAACGTGGGGGCTCGAGACGCTTGGAATTACAGGT
>neg_control_4114831:4114981	ACCTGTAATTCCAAGCGTCTCGAGAGAAAAGTACGGGTCAATCACCAGACCGGTATTGCTGCGGATATAATCTTCTAAACCGTCACGTTTTAAATGCTCGCAGATTTCTGCGGTACGACGGCACTGCCAGACAATGGCGTTATAGATAGGCTTGCCGGTTTCTTTTTCCCAGACGCTAGCGGTGTTTAGTTAGCATCC
>neg_control_685372:685522	GGATGCTAACTAAACACCGCTAGCCCCGTGTTTGCGAACAGGTACGCGCCGCGATTCAGTCGCTGCCGCGAGGGCAAAAAAATGCCGCGCTGGCGATGGGCCTGACGCTACCGCAGGCTTATCGATACGTACTGCTGCCTAATGCTTATCGCGTTATCGTCCCGCCGATGACCTCTCGAGACGCTTGGAATTACAGGT
>neg_control_2032372:2032522	ACCTGTAATTCCAAGCGTCTCGAGCAGGTTTAGGCTTTGGTCAGAATGGTACTTTCGACTATGGTCGTAACTACGGTGTCGTATATGACGTAGAAGCATGGACCGATATGCTGCCAGAATTTGGTGGCGATACCTATGCTGGCGCTGACAACTTCATGAACGGTCGTGCTAATGGCTAGCGGTGTTTAGTTAGCATCC
>neg_control_3383772:3383922	ACCTGTAATTCCAAGCGTCTCGAGGAAGCTCGTAGCGGTGACACCTGGCACGCTACGGCTGAACTGTACAAATAAACCCTCATCGTCTTGTCCGACGATATTGCCCCCGGTTCGGGGGCTTTTTTTTGCGCTAATGACGAACATTAAAACGCAAATGCCCTTCCAGCTCTTCCTGCTAGCGGTGTTTAGTTAGCATCC
>neg_control_2774808:2774958	ACCTGTAATTCCAAGCGTCTCGAGGCTCGTTGATATCCGTGTCCCTGACCATCTGATTGTTGGTGGCAGGCAAATCTATTCGTTCGCAGAACACGGTCTGCTTTGAGGTATTACATGAGAATTATCAGTAAACGCCGGGCAATGACGATATACCGCCAGCATCCTGAGTCCCGAGCTAGCGGTGTTTAGTTAGCATCC
>neg_control_1625857:1626007	ACCTGTAATTCCAAGCGTCTCGAGCAACAAAGGCCTGGTATATATGACGCGCGCCGTCTTACCGGGTATGGTTGAACGTAATCATGGTCATATTATTAACATTGGCTCAACGGCAGGTAGCTGGCCGTATGCCGGTGGTAACGTTTACGGTGCGACGAAAGCGTTTGTTCGTCAGCTAGCGGTGTTTAGTTAGCATCC
>neg_control_3582132:3582282	GGATGCTAACTAAACACCGCTAGCACGAACTGAATATATTTTCTGTGCCAATATTATCTCTAATTTCAAAAAAGTTACTTTTAATGTCGGTAATGACTCCAACTTATTGATAGTGTTTTATGTTCAGATAATGCCCGATGACTTTGTCATGCAGCTCCACCGATTTTGAGAACGCTCGAGACGCTTGGAATTACAGGT
>neg_control_1888878:1889028	ACCTGTAATTCCAAGCGTCTCGAGTCACCGTGCCAGATACCGTTTTCATCACGCTGATATTCGGCCCAGTAAACTTCGCCCATTCGCGCGTCAATGGCTGCCAGCACGCGGGTTGCGCCGTTTTTGCGCCACGCCCCTTGCGCCATCGTCATTAGCGTGGAGACGCCAATCATCGCTAGCGGTGTTTAGTTAGCATCC
>neg_control_3099294:3099444	ACCTGTAATTCCAAGCGTCTCGAGGCGCATTTTGCTGCTTTCGCCCATCTCCTGAACGATAATTTTATCCAGAGCAATACGGGCTTTCTCGACGCGGCTTTTCGCGCCTTCATCAATCCACGGCAGCGTGCTGCGTAGTTCAGCCTGATAATCCTTCGCCTGCTCGCGCTGGGCGCTAGCGGTGTTTAGTTAGCATCC
>neg_control_1392536:1392686	ACCTGTAATTCCAAGCGTCTCGAGTGATGTTATCCGCGCCTCGTGGGTGGGGGATTATAATGAACCCTCCACTTTCCTGACATTATTAACGTCAACGCATTCAGGAAATATTTCACGCTTTAACAATCCGGCATATGACAAAGTTCTGGCCCAGGCATCGACGGAAAATACCGTGCTAGCGGTGTTTAGTTAGCATCC
>neg_control_1756134:1756284	GGATGCTAACTAAACACCGCTAGCCGTTCGCTGGAGCGTGGCATTAAATTACCGCCAGTCGTTCCTGCCGGACCAAATAACCCGCTAGGACGTTACGCACTGCGCCTCGCGCATGGTAATGGCGAATACCTCATTCATGGTACCAGTGCGCCGGACAGCGTCGGTTTGCGCGTCCTCGAGACGCTTGGAATTACAGGT
>neg_control_1360146:1360296	GGATGCTAACTAAACACCGCTAGCCCAGTGGTTGTGCCCGGCTGGTACGTTTCAAAGATCATCGCCAGCGTGCGATTCGGGTTACCGTTATGAACCAGCTTCATTGACACACCCTGACTACCCATCTCAATTAAGTCGTCCTGATTAATGACGACCTGCGGCTCATCAGGTTTTCTCGAGACGCTTGGAATTACAGGT
>neg_control_451789:451939	GGATGCTAACTAAACACCGCTAGCGTACGGTGGGATTTTGATGCAGCGCCTGTCACTGTTCCGGGCACTGCTGATTTTCGGCATTTTACAAGGTGCGTCTAACGCCGGTTACTGGCTGCTGTCGATTACTGATAAGCATCTCTACAGCATGGGCGCAGCCGTCTTTTTCGAAAACTCGAGACGCTTGGAATTACAGGT
>neg_control_831020:831170	ACCTGTAATTCCAAGCGTCTCGAGGGATATTGAAGAGCTGCCGCACGTCGTCAACTATGAACTGCCAAACGTACCTGAAGATTATGTCCACCGTATCGGGCGTACCGGTCGTGCGGCTGCTACCGGTGAAGCGTTGTCGCTGGTGTGTGTTGATGAACACAAACTGCTGCGTGAGCTAGCGGTGTTTAGTTAGCATCC
>neg_control_570540:570690	GGATGCTAACTAAACACCGCTAGCCCTCTTGCCAGCATACTCTCACCCTACTTTATCTCATAAACTGGTGTTATCTCAGCGGTTGCGATTTTATTAGCATTAAGCATATAACCAACTAACGCTCCGCTGGAGTTAGAATCTACAGGAATCTTTTCAGTTTTTAGAGCCCATACTCTCGAGACGCTTGGAATTACAGGT
>neg_control_3563955:3564105	ACCTGTAATTCCAAGCGTCTCGAGCGTAAGCGACTCCCAGAATCTCTTCGGTTTCAATCCAGCGCGTTTTTTTACCTTCCTGCTGAATGCGACCGCCAAAACGGACTTTATAGCGCGTGTTGTGGCGTTTGAATTCCCACGGGTTACCGTATTCCAGCCAGTAGTCTGGCGACTGCTAGCGGTGTTTAGTTAGCATCC
>neg_control_149193:149343	ACCTGTAATTCCAAGCGTCTCGAGGTGACCACATACAGGAACGGCACGTTCGGTCAGCATTTGTACGGTTTCTACCAGCCACTCACCGCCTTCAATTTTGACCATGTTAGCACCGGCACGCATAACCGTTGCGGCGTTTTCGAAGGCTTGTTCCGGCGTGGCATACGCCATAAAGCTAGCGGTGTTTAGTTAGCATCC
>neg_control_1673822:1673972	GGATGCTAACTAAACACCGCTAGCGTTCGGTGGTGGCGTTCGGCAAACTGTGTGGCAAGATTTCGTCTAAACCATTGATGCTGCCAAACCGTCACAAAATGAACCTGGCGGCTCTGGTCGTTTCCTTCCTGCTGCTGATTGTATTTGTTCGCACGGACAGCGTCGGCCTGCAAGCTCGAGACGCTTGGAATTACAGGT
>neg_control_1716781:1716931	ACCTGTAATTCCAAGCGTCTCGAGACTTGTTCAGAAATGGTCACGGCGGTGAGTTCTGCCAGTGTCGCCTGCACATCTCGGGGATCAACACCCGGAAAATGGCGCAAATGGCGCTCCAGCCAACCATAGTTAAAGTATTCGCGTCCGGTGCTTTTCGGTGCAGGTTGCGAGAAAGCTAGCGGTGTTTAGTTAGCATCC
>neg_control_1004439:1004589	GGATGCTAACTAAACACCGCTAGCTTATTTTTAATCGCGGTTAAGAGATCATCCAGCGCTTCACCATATTGCAGCGTGCGTAATCCTGGGGTATTCGGCGATGAAATATTGATGGCGATATATCCCGCATAGGCATAGATTTTTTCCATACAAATCAGATAGTCATCTTTGCCCCTCGAGACGCTTGGAATTACAGGT
>neg_control_4397374:4397524	ACCTGTAATTCCAAGCGTCTCGAGTACCAGTAGAGTTGATAAGCGTTGATTCTGCCCTTATTTACAAAGGGATGGATATCGGGACGGCGAAGCCGAACGCTGAAGAGTTACTCGCCGCGCCGCACCGATTGCTGGATATTCGCGATCCGTCGCAGGCTTACTCGGCTGCTGATTGCTAGCGGTGTTTAGTTAGCATCC
>neg_control_1291308:1291458	ACCTGTAATTCCAAGCGTCTCGAGTAATCTCGCTATTGTGGGTCGTTACGTACTTAGCGCGGATATTTGGCCGTTGCTGGCAAAAACCCCTCCGGGAGCTGGTGATGAAATTCAGCTCACCGACGCAATTGATATGCTGATCGAAAAAGAAACGGTGGAAGCCTATCATATGAAGCTAGCGGTGTTTAGTTAGCATCC
>neg_control_1846314:1846464	ACCTGTAATTCCAAGCGTCTCGAGCCGCCAAACCCCTGGGCAACTGCTGCCATTTGCATCGCCATGACCGCGCATCCGGCAGACATTTCCTGTTCCCAGCGCGGGACTTTATGATTCTCTTCGCATTTCGCCACCACCGTGATGATGAGCGGTGCGCGGAACGGCGCATTACGGGCTAGCGGTGTTTAGTTAGCATCC
>neg_control_1495182:1495332	ACCTGTAATTCCAAGCGTCTCGAGGACGCTCAGTTCTTCCATATGGGAATGGGATTCCGTCGCCGCGTTCGTATGTTTTCTGTAGATCCAGCAACACATCTGGCGCGTGAAATTCACTTTCGCCCGGAGTTGTTCAAATACAACGATGCAGGTGTTGATACAAAACAATTAGAAGCTAGCGGTGTTTAGTTAGCATCC
>neg_control_2211768:2211918	ACCTGTAATTCCAAGCGTCTCGAGAGCAACGGTAAGGTACTTCGTTGCCATCAGCGTAGACCACTTCACCGGTTTCAATCGCTTTTAAAGTATAAGTTGAAGAAATCGGTTTGCCGGGTAAATGGTGGTCGTCACCAATTCCGGTAAAGGCCAGCAATTTCTCTCGATCGGTAAGCTAGCGGTGTTTAGTTAGCATCC
>neg_control_2078014:2078164	ACCTGTAATTCCAAGCGTCTCGAGTTTCCAGACGTGGGCGTTCGAGTAAGTTCGGTGAGAATGCAGATTGATAGACCCGATTATACTCGGTCAGACTTTTCGCCAGTTGAATGCGCCAGTGGATGAACGCCCGTTGTGGCCAGATACCGGTAAACAACATTGCCAGTAAAGAGCGCTAGCGGTGTTTAGTTAGCATCC
>neg_control_3932325:3932475	ACCTGTAATTCCAAGCGTCTCGAGGAAACCGAATCCCTGTTCCGCGTCATCCGCGAGCTGAAATCGCAAGGCCGCGGTATTGTCTATATCTCCCACCGCATGAAAGAAATCTTCGAGATTTGCGATGACGTTACCGTTTTTCGTGATGGGCAATTTATTGCTGAGCGCGAAGTGGCTAGCGGTGTTTAGTTAGCATCC
>neg_control_1923691:1923841	ACCTGTAATTCCAAGCGTCTCGAGCGAATGACCATCATTGCCGGCCTTCCCGTTGAATATAACGATCGCTTTATTCGTGGAATTGCGGTGTTCGCACCGTGGCGAAAAACGCCTGGGATCTACCATCAGAGTCATGGTGCATGTCTGGGCCGTCGTTCCAGAACCATCACGGTGGCTAGCGGTGTTTAGTTAGCATCC
>neg_control_473028:473178	ACCTGTAATTCCAAGCGTCTCGAGGCTGGGGGCGTGTTCTGGCGCGATTGCCGGTCTGGTCGGCGTGACGCCAGCCTGCGGCTACATTGGGGTTGGCGGCGCGTTGATTATCGGCGTGGTAGCTGGTCTGGCGGGCTTGTGGGGCGTTACCATGCTCAAACGCTTGCTGCGGGTGCTAGCGGTGTTTAGTTAGCATCC
>neg_control_4389962:4390112	ACCTGTAATTCCAAGCGTCTCGAGCGTCGTTTCCTGTTTAAATACATGCCGGAGCTGGAAGCCTACTTCCACTACCGTTATCTCGATGTCAGCACCCTGAAAGAGCTGGCGCGCCGCTGGAAGCCGGAAATTCTGGATGGTTTTACCAAGCAGGGGACGCATCAGGCGATGGATGCTAGCGGTGTTTAGTTAGCATCC
>neg_control_1813477:1813627	ACCTGTAATTCCAAGCGTCTCGAGGAGTTAAGCAAAGTCGTTCGTCCGTATATTCGTGAGCGCGTTGTTGACCAGCTGGCGCATATTGATCTCACTCTGGCCCAGGCGGTGGCGAAAAATCTCGGTATCGAACTGACTGACGACCAGCTGAATATCACCCCACCTCCGGACGTCGCTAGCGGTGTTTAGTTAGCATCC
>neg_control_2198:2348	ACCTGTAATTCCAAGCGTCTCGAGTCTGCTCAATGCAGGTGATGAATTGATGAAGTTCTCCGGCATTCTTTCTGGTTCGCTTTCTTATATCTTCGGCAAGTTAGACGAAGGCATGAGTTTCTCCGAGGCGACCACGCTGGCGCGGGAAATGGGTTATACCGAACCGGACCCGCGGCTAGCGGTGTTTAGTTAGCATCC
>neg_control_602454:602604	ACCTGTAATTCCAAGCGTCTCGAGTGCTGCTGATGTGCACGATGGATGATATGCGCTTGTCAGCGATCCTGCTGCCGGTGTGGATTGTATTCCTGTTTATGGCATTTAAAACGCTGCGTCGGAAATAAGGCATTCACGCTACATCCGACAAAACGATGTCAACCATCCGAAACCGCTAGCGGTGTTTAGTTAGCATCC
>neg_control_4266230:4266380	ACCTGTAATTCCAAGCGTCTCGAGATTTGGTGTCTATCTCATCGCCAGCGGTCGCATGTGTGTCGCCGGGTTAAATACGGCAAATGTACAACGTGTGGCAAAGGCGTTTGCTGCGGTGATGTAATGCAGGAAAGCAGGCTGGAGCTACCCAGCCTGCAGTGAAATTAAACTGTCGCTAGCGGTGTTTAGTTAGCATCC
>neg_control_604915:605065	GGATGCTAACTAAACACCGCTAGCTGAGTTACCCTTTGTCGAGCTTTGCTGGCCTTTTGGCCCGGAGTTCGATGTTTTTAAAATTGGCGGCAAGATTTTTATGCTGTCGTCGGAGCTACGCGGCGTCCCCTTTATCAATCTGAAGTCCGATCCACAAAAATCCCTGTTAAATCACTCGAGACGCTTGGAATTACAGGT
>neg_control_1029622:1029772	ACCTGTAATTCCAAGCGTCTCGAGTTCGGAAACAGTCGGTATAAATAGCGGCTGTTACCTTTTTCTTCGCCAAATTTATTCGCCATCGCTTTTACCAGCATACGAATCGCCGGAGAAGTATTGAATTCCAGATAGAAATCACGCACAAAACGCACCACTTCCCAGTGTTCCGGTGCTAGCGGTGTTTAGTTAGCATCC
>neg_control_2248205:2248355	ACCTGTAATTCCAAGCGTCTCGAGGAAAGCGGAAGCCAGTAAAGTAACCGTGGCTGTTGCAACCGTTGTTATCTTCGGGACCGTCGCGATTTTCCTCTACCCGGCGATATATCCGCTGATGTCTCAATGGTTTAGTCCGGAAACTTTCGGTATCTACATTGGTTCTACTGTGCAGCTAGCGGTGTTTAGTTAGCATCC
>neg_control_2165897:2166047	ACCTGTAATTCCAAGCGTCTCGAGTCGATAGAATCCTCCTTCATAGCACGATGCCTTTCACTTATCGGCATCGTGCTCCCACAGGTTCCGGCTACGCACAGCCAGAACGCGCATATTTGACGCTTACCAAAAAATATTCTCACTCTCCACATTTGAATGTCAGACGAGCGACACGCTAGCGGTGTTTAGTTAGCATCC
>neg_control_4553475:4553625	ACCTGTAATTCCAAGCGTCTCGAGGTATAACCTGAATGTTAGTACTCATTCTTCCTGGTAGTTATTTACCAATATAATTCCATTCACCATTTTTTAATTCAAACAGTTCTGGAAGAGATGACGGTTGCAGAGTCATACGTTTGAGTGGTGCATTTTCATCACCCGGGATAACTTGCTAGCGGTGTTTAGTTAGCATCC
>neg_control_183068:183218	ACCTGTAATTCCAAGCGTCTCGAGATTGTCTCGCTAACCGAAATGGTGGTGTTGAAACCGGCGTTGAACTCTTTTGGGCGCTGGGATGCAGAAGATCATCGTAAGCGAGTTGAACAACTGATTACCCGCATGAAAGAGTACGGCCAGCTGCGTTTTCGCGTTTCACTGGGCAACGCTAGCGGTGTTTAGTTAGCATCC
>neg_control_1111942:1112092	ACCTGTAATTCCAAGCGTCTCGAGGTACGCATGCTGTTCCATACGGTCTTCGTTGTCAGCGCGTTCCTTGGCTGGGAAGTGGTGTGGAATTCACCGCAGCGTGATGATGACTCCACTTCCTGGGGTGAAGCGTTCAAACGCCACGGCTCACAGCTGCTGTTAGGGTTAGTGTGGGCTAGCGGTGTTTAGTTAGCATCC
>neg_control_1687121:1687271	ACCTGTAATTCCAAGCGTCTCGAGCCTGATGCCGAACGTTTAAGCGAACTGTTCGCCAGCCTGTTGAATATGCAGGGTGAAGAAAAATCCCGCGCGCTGGCGATTTTAAAATCGGCCCTCGATAGCCAGCAGGGTGAACCGTGGCAAACGATTCGTTTAATTTCTGAATTTTACGCTAGCGGTGTTTAGTTAGCATCC
>neg_control_3720906:3721056	ACCTGTAATTCCAAGCGTCTCGAGTCGGTCAGCGTTTGCAGATCAAGGTTGAGGTTCTTCTCAACGATAATTCGCAGCACGCCAAGCGCGGCACGACGCAGCGCAAACGGGTCTTTGTCGCCTTTCGGATGCTGACCGATACCGAAGATACCCGCCAGGGTATCCATCTTGTCAGCTAGCGGTGTTTAGTTAGCATCC
>neg_control_1051760:1051910	ACCTGTAATTCCAAGCGTCTCGAGTGTTCGTACCTGAATTAATTTATCGACCGGGATCCGTGATGGGCAATTTTTTGCGCATTTGCCACAGTCGATACAACTTTCGGCATTGCGACGAATCTTAAACGGCGACAATAGCGAAACCACGCCCATCAGCGCGCCATATGGGCAAAGGCTAGCGGTGTTTAGTTAGCATCC
>neg_control_3330000:3330150	GGATGCTAACTAAACACCGCTAGCTCCCTCTGGCAAAGCCTGGAGTGATAGCGCAGCTTAGCCACTGGCAGCTCGCATGTTTAATTTTTTGCGGACTGAATACCTTGGTAGGATATGGCGCCCTGGCGGAAGCGATGGCTCGCTGGCAGGCAGCGCAGGTGAGCGCGATCATCACTCGAGACGCTTGGAATTACAGGT
>neg_control_4043361:4043511	GGATGCTAACTAAACACCGCTAGCTAATGTCATCATCCCGCTGATTTGTTTATCAGCCTGCTTTTGCGCTTTTTCCGCATCCATTCCTTCAGATAAATTAAGCTGTTTTGCGGTTTCTGTGACGACATTAAGCGGTAACTTCACATCAAAATTGAGCGATTTGATATCTTTGTTCTCGAGACGCTTGGAATTACAGGT
>neg_control_3488483:3488633	ACCTGTAATTCCAAGCGTCTCGAGGTAAGTGGATTTGCCAGCCCCCGAAATACGCCCTCACCGTTATGTGTAATCGGCGAGGTTTTGCCGTGCATGACCTTTGCGGCGCGCACAACTTTACCGCCAAATGCCTGCGCCATTGCCTGATGACCGAGGCAGACGCCAAGAATCGGCGCTAGCGGTGTTTAGTTAGCATCC
>neg_control_3010434:3010584	GGATGCTAACTAAACACCGCTAGCGCCAAATTGCCTGATGCGCTACGCTTATCAGGCCTACAAGTGCATTGCAATCTATTGAATTTGCGATGTTTTGTAGGACGGATAAGGCGCTCGCGCCGCATCCGGCATCAACAAAGCGCACTTACTTGACAATCTTTGGCCGGATGGTATCTCGAGACGCTTGGAATTACAGGT
>neg_control_3926054:3926204	ACCTGTAATTCCAAGCGTCTCGAGGCGGTATCGGCCAGTCTCGTTTGACTATGCTGCTGCTGCAACTGCCGCATATCGGCCAGGTTCAGTGTGGAGTATGGCCAGCTGCTGTTCGCGAGAGCGTCCCTTCTCTGCTGTAATAATTTATCGCCGCCAGCGTCTGAGCAGGCGGCTGCTAGCGGTGTTTAGTTAGCATCC
>neg_control_573907:574057	ACCTGTAATTCCAAGCGTCTCGAGAATCAGCCTATTTAGACCGTTTCTTCGCCATTTAAGGCGTTATCCCCAGTTTTTAGTGAGATCTCTCCCACTGACGTATCATTTGGTCCGCCCGAAACAGGTTGGCCAGCGTGAATAACATCGCCAGTTGGTTATCGTTTTTCAGCAACCGCTAGCGGTGTTTAGTTAGCATCC
>neg_control_4435071:4435221	GGATGCTAACTAAACACCGCTAGCGCGCGCATCGCGGACCTGAATCTGCTTGCGCACACCGCACTCTTCTTTCCACGCTTTGCCTTCTGCCGCGCTGTACATTACGTTCATTACCGGCGCATACACCACGCCTAAAATCGGTTTGCCATGGTCAATGAGCGCAATGTTAACGGTCTCGAGACGCTTGGAATTACAGGT
>neg_control_3817426:3817576	ACCTGTAATTCCAAGCGTCTCGAGCCTGGTATTCGGCTTTTTTGCCCGCTTACTGGCGCTACGCCTTAAGCTGGGATTACCGGTCTTTTACTACAGCCACGAAGGACACTAAGGTTCAAAACCTGTGATCTGCTGGGCAGCCAGCCAACTGCCCAGCTTCTTGATTTGCGCATTGCTAGCGGTGTTTAGTTAGCATCC
>neg_control_4047560:4047710	ACCTGTAATTCCAAGCGTCTCGAGGGGCGATGATTGCCGTTGATGCGTGGTTACAGGCTGAGCAACCGCGTGTACGTATGATCATGCAGGTACACGATGAACTGGTATTTGAAGTTCATAAAGATGATGTTGATGCCGTCGCGAAGCAGATTCATCAACTGATGGAAAACTGTAGCTAGCGGTGTTTAGTTAGCATCC
>neg_control_2352583:2352733	ACCTGTAATTCCAAGCGTCTCGAGGCGCAATTGCAGGGCAGCGTAGAACTTGCTCACCAGCGGGTTACGCCGCTCGGCACTCTGCGCTCTACCTGGCTAAGTTCGCCAGAAGTCCCCGTCTGGCCGCTGCCCGCGAAGAAAATATGTGTAGTGGGAATTAGCGGCCTGATGGATGCTAGCGGTGTTTAGTTAGCATCC
>neg_control_971716:971866	ACCTGTAATTCCAAGCGTCTCGAGACCTGCAACGCGCGCCAGTGGCGGAGTCGTTCATCTGGCGGCGTTGGTTGTATGTGTTATGGGATGAAGTTGCGCAACTGGTTAATACCGGACGATTTAGTCGGCGCAACTTCGATCTGGCATCAAAATCACTCTTGCCGTGGCTCGCCTGCTAGCGGTGTTTAGTTAGCATCC
>neg_control_1316103:1316253	ACCTGTAATTCCAAGCGTCTCGAGGGCACCGGTTTCGGCGATGATTTCGGTTTTACCCATCCGCTTCGCCAGCAACGCCTGCCCCAGCACCTGGTTAGTTTTATGCGCGCCGCCGTGCAGCAAATCTTCACGCTTGAGATACAGCGTGGTGTTCGTCCCGGCTGTAATGTTCTGGCTAGCGGTGTTTAGTTAGCATCC
>neg_control_4032790:4032940	ACCTGTAATTCCAAGCGTCTCGAGGTGCTTCTATTCGCTATGGTCACTACCATTCAGCGTTCCAGGAATTTGTCAAAAAACATGCGACGCGGCTGAATTCGATGCCGAGCGCCTTTTACTCCGTGAATCTGGTGGCGCGCAAACCGGAGAAGCGTACTCCACAGACCAACAGCTGCTAGCGGTGTTTAGTTAGCATCC
>neg_control_4406096:4406246	GGATGCTAACTAAACACCGCTAGCCCAGCAGCTCCGCGTAGTCACGCGGTTCCGGCTTGTTACCGCCCGGCAGTTCCAGCCCCAGCTCCGCCAGCACTGAACGGAAAGAGGTAATCGCTTCGGTGCTCGGCTTGTCGTGAATACGGAACAGTGCCGGTTCTTTCGCTTTCTCAACTCGAGACGCTTGGAATTACAGGT
>neg_control_1754713:1754863	GGATGCTAACTAAACACCGCTAGCCCGCCCTGAGTAGCAACCACGATCAGCGGAGCATCCAGTTTTTCAGCAGTTTCAACGGCACCACGGCATACCGCTTCGGTAATGCGCAGTTTACGGTTGTCATTGTTGAACTCGAGACGGCTGTTCATCACGCGGTCGGTACGTTCGCAGCTCGAGACGCTTGGAATTACAGGT
>neg_control_4495909:4496059	ACCTGTAATTCCAAGCGTCTCGAGAGGTTTATCAGTCCATTTGAATATGCAAAGATTAATAATCCATTAAAACAGTAATCATCCCGGGCAAATGCCCGGGAATTATTCTAGGATTATTTTCTTTGTTAAAAAAGACAAACGGTATTAACTGATGTATTTACTATTTACCGCTCCGCTAGCGGTGTTTAGTTAGCATCC
>neg_control_1045358:1045508	ACCTGTAATTCCAAGCGTCTCGAGCCAGATATTGCCCAACGCTAAGTTTCATCAGTACGCCATTGAGCGTCGGCGGGTTCCAGTAAGCCGTCACGAAACCTGTTGGCGTGGAATAATCGGTGAAACGCATCATGTTGTCCCAGTCACGTTGCTTCACGTAGTTAACGTCCACACGCTAGCGGTGTTTAGTTAGCATCC
>neg_control_2280988:2281138	GGATGCTAACTAAACACCGCTAGCACACTGCGTCAGTTGACGAAGTTTGCCGGTAGCGGCGGTGGCTTGACTATTAACTTTGATGCGATGCTGTTAGGTGAACGCATCTTCTGGGATCCAGCAACCGATACCTTGACCATTAAAGGCACGCCGCCGAATTTGCGCGACCAATTGCTCGAGACGCTTGGAATTACAGGT
>neg_control_1622146:1622296	ACCTGTAATTCCAAGCGTCTCGAGGACCCGAACGACGGCCGGCGCGCTTTTCTTATCCAGACTGCCACTAATGTTGATCATCTGGTCCGGCTGAACTTCTCGTCCATCAAAGACGGCCGCAGGAATAACGACATTAATTTCACCGCTCTTATCGCGAAAAACGTAACGGTCCTCGCTAGCGGTGTTTAGTTAGCATCC
>neg_control_630096:630246	ACCTGTAATTCCAAGCGTCTCGAGGTTCCTGTTTATCACCATCGCCTGTGGCGCGGTGTCTGGCTTCCATGCGCTGATCTCTTCTGGGACCACGCCGAAGATGCTGGCGAACGAAGGGCAGGCGTGCTTTATCGGCTACGGTGGGATGTTAATGGAATCCTTCGTGGCGATTATGCTAGCGGTGTTTAGTTAGCATCC
>neg_control_2631627:2631777	ACCTGTAATTCCAAGCGTCTCGAGCGGCGTCATGTAAACGCTAACCGGCTGGTTCAGGTCGGTAACAAAACGCACGTCACGACCGGTGATAATACCCACCAGTTCGTTTTCTTCGGTAACGACCGGATAGCCCGCAAAACCGTTACGCTCGGTCAGTTCTTTCACTTCGCGCAGGCTAGCGGTGTTTAGTTAGCATCC
>neg_control_2423213:2423363	GGATGCTAACTAAACACCGCTAGCTTTCGCCATCGTCTGTGGCGTGATTTACCTGGTTTTCACCACTGTTTCCAATGGTGTGCTGCTGTTCCTTGAGCGCCGCTACTCCGTGGGTGTGAAGAGGGCTGACCTGTGATCGAAATCTTACATGAATACTGGAAACCGCTGCTGTGGCTCGAGACGCTTGGAATTACAGGT
>neg_control_3435623:3435773	ACCTGTAATTCCAAGCGTCTCGAGTGCGAAAAGCAGATATTGTTGGTGTTTCCTCATTGCGCCGCGGCGTAGCAGAAGCTATTGAAGCCGTTGCTCACGGTGATGAAAGCACCTCACGCGTTGTCGGCAGAGTCATTGACGAAATCAAGCTACCGCCAGGAACGATTATTGGAGGCTAGCGGTGTTTAGTTAGCATCC
>neg_control_3318276:3318426	ACCTGTAATTCCAAGCGTCTCGAGAAACATCGGGACATGATATGCCTGCTGGCTAGCCTCCCTGCCTCCATGAAAATAGACGTTCTTCTTCGTAGGGTCACGTTCCAGGCCGTGGTCGGCAAAATACATGACCGAGGCGCGGCGATCTTTTAATAATTCAAAAACCTGACCTAGGCTAGCGGTGTTTAGTTAGCATCC
>neg_control_926220:926370	ACCTGTAATTCCAAGCGTCTCGAGGTACATACCGCCGACAAGCTCATCTTCACGCCAGACTTCAATGGAGTGGGCATGGCCGAGTTCGTGAAGGCGATGGTAGGCTTCGACCACGCCACGCGTGATCCAGGTTCCTTCTTCGCGATCGCTGGCACAGCCTTCAATGACCTGACCGCTAGCGGTGTTTAGTTAGCATCC
>neg_control_533510:533660	ACCTGTAATTCCAAGCGTCTCGAGACCGGTCAGCAAAATGGCGGTTACAGTTCGTGAAGCGGCGCTGGTGCCTCGCGTGCTGCAACAGGCATTTCACCTGATGCGTTCTGGTCGTCCGGGTCCGGTACTGGTGGATTTACCGTTCGACGTTCAGGTTGCGGAAATCGAGTTTGAGCTAGCGGTGTTTAGTTAGCATCC
>neg_control_518144:518294	ACCTGTAATTCCAAGCGTCTCGAGCTGCGCGATCAACACTTTCTGGTGAATCCAGATCGATCAACACGCCGGTAAATCCCATGCTGTTCATGCGCTCAACATCATCCGGTTTCCGGCAACCTGCCAGCACATGAAAACCCTGGCGTTTTAATTCGAGCGCGCTTTCCAGGCCAAGCTAGCGGTGTTTAGTTAGCATCC
>neg_control_1095853:1096003	ACCTGTAATTCCAAGCGTCTCGAGGGTTATTGAAGTGATGTGGATTACGCTGGTGTCGGTATTGGCAACGCTTGTAGAATGGCGGATTTGGTTTGAAGCCTATTTTTTACTCTGCTATGTACCGTGCTTAATTTACTATTTTTTCTATTGTCGATTCCTCTGGCATAACGATTTGCTAGCGGTGTTTAGTTAGCATCC
>neg_control_912274:912424	ACCTGTAATTCCAAGCGTCTCGAGAGAGATCTTTGAGATCGTGACCGGAAATCAGAATGCATTTACCCGCCGTCGCTTTGACGTTGACCTGGGTTGGCGTCGGGTGACCGTATTTACCGGTTTCGCCTGCATCCAGAATGCTCATCACTTTGAAGTTCATCTGGCCGATTTCCAGCTAGCGGTGTTTAGTTAGCATCC
>neg_control_4013700:4013850	GGATGCTAACTAAACACCGCTAGCGTGCCTGACTCGCAGGTGCTGGCCGATCTCGATCATGTCGCCAGTTGGGCTTCCCGCAACGGCGGCGATGTTCATCGTTTAATGATCACCGGATTCTGCTGGGGTGGACGTATCACCTGGCTGTATGCCGCGCATAATCCACAGCTAAAACTCGAGACGCTTGGAATTACAGGT
>neg_control_880856:881006	GGATGCTAACTAAACACCGCTAGCTCCCGACAACCTGACCTTTTTTCAGCGGTGCGGTAAGCTGCGGTTCCGTTAACGTATAACTCGCTTTCAGGTTTTTCAGCTGCCCACGCGGTATGGTCACTGAGCCCGCTTCACCTGCCCCGAGATTCACTTCGCTCTTATCACCAAACCCTCGAGACGCTTGGAATTACAGGT
>neg_control_3265482:3265632	ACCTGTAATTCCAAGCGTCTCGAGTTGTTGGAGAACAAACATTTATTTTATCAATATTTTAAAATTTCGAATACATGTATTGATCATCTCGAACAATTGATTAACGTCAACTTTTTCTCTTCTGACAGGACGTCATTTTGTGAATGCAATCGTTTTCCATAAATTCTTCTCCCCGCTAGCGGTGTTTAGTTAGCATCC
>neg_control_826002:826152	ACCTGTAATTCCAAGCGTCTCGAGCCGTTGTCCTCCGCTCGCTGCATTTGCCAGATCTGCCAGATCCCTTCGACATACCCCTGTACAAAGTTAGCGGTATTCGGCTCACTGCCGTCGGTGATCACCTGAATCGGTGCGGTGGCGTTGGCGCGCTCCATCTGTTCCGCAAAATCCGCTAGCGGTGTTTAGTTAGCATCC
>neg_control_1517496:1517646	ACCTGTAATTCCAAGCGTCTCGAGGGGCGAAACGTTGGTGGTAGCTGCGGCGACAGGACCAGTGGGGGCGACGGTGGGGCAAATCGGCAAACTTAAAGGTTGCAGAGTGGTGGGGGTAGCCGGTGGCGCGGAAAAATGCCGCCATGCTACCGAGGTGTTAGGCTTCGATGTTTGGCTAGCGGTGTTTAGTTAGCATCC
>neg_control_2312520:2312670	GGATGCTAACTAAACACCGCTAGCATGATCGGCAATTTTGTTACTTATGACAGTGCGGTTCGATTCCTGATCGTGAACCAGCAGGCCGAGCGGCAGCAGTGAGACTATCTCTTCATTGATTGCCCGTAAAATGCGCAATTCGTTATTGACCGCCGTGCTGGGGACGTTTTCTGTCTCGAGACGCTTGGAATTACAGGT
>neg_control_798720:798870	ACCTGTAATTCCAAGCGTCTCGAGGTTGGCGAGCAGGGGCTACTGCATGAAAAAGGCCGCTATGCGGTCGGGCAGGGACCAATGTGGGTGGTGGTTAACGCACACTAACCGCTGATTTACCCGGCGCAGTCTCTCCTGCGCCGGTGTATTAACCTATCTCCTGTAACGCGTGTCGCTAGCGGTGTTTAGTTAGCATCC
>neg_control_4104776:4104926	ACCTGTAATTCCAAGCGTCTCGAGTTCCTGTTTTTGACGGGTATTCAACATCTGATATCTCCAACACCGATGACAGATCCAGGCGTCGGGGTTATCGTGACAATTGTGGCGCTAATTTGTACGATTATCCTTGTCTCGTTTCAGCGTTGGGTGGTGCGGCGGACGCAAAGCCAGGCTAGCGGTGTTTAGTTAGCATCC
>neg_control_3337446:3337596	GGATGCTAACTAAACACCGCTAGCTCTCATCATGTTTGATGAACCTTTTGTTGGGCAAGATCCCATCACCATGGGCGTACTGGTGAAGCTGATTTCTGAGCTGAACAGCGCGCTGGGCGTGACTTGTGTGGTGGTTTCTCACGATGTGCCGGAAGTGTTAAGTATTGCGGATCACTCGAGACGCTTGGAATTACAGGT
>neg_control_4258762:4258912	ACCTGTAATTCCAAGCGTCTCGAGCCCATTGAACAATGTACTTTTGATGTAGAAACTAAGAATGACCTTCCCTCCACGGTTCAGCTATTTTATGAGGAATCTAAGGATAATGAACCTTTAGCGAATATACATTTTCAAGCAATAGGTTCTGGTTTTTTAACGTTTGTTAATGCCGCTAGCGGTGTTTAGTTAGCATCC
>neg_control_1314615:1314765	ACCTGTAATTCCAAGCGTCTCGAGCCTGCAATGGAGGTGCAGCGTTGTACTCTTTCAGCTTCGCAACCAGATGATTGAGGGGTAACGCGGCGCGGTTTTCTGCGCCGGTCACGCCTGCTCGTGACAGCAAATAGGTGTAACCACGACCGTAAGAGGCTATCTGGCGCAGCAGGTGCTAGCGGTGTTTAGTTAGCATCC
>neg_control_4004740:4004890	ACCTGTAATTCCAAGCGTCTCGAGTGACCTGCAAATTGTGGTGGCGACGGTGGCGTTCGGCATGGGCATCAATAAACCAAACGTTCGCTTCGTGGTCCACTTTGATATTCCGCGCAATATCGAATCCTATTATCAGGAAACCGGACGCGCCGGGCGTGATGGCCTGCCCGCGGAGCTAGCGGTGTTTAGTTAGCATCC
>neg_control_3218303:3218453	GGATGCTAACTAAACACCGCTAGCATGGTCGCGCCAATCGGCATCACGCCGCCGCCGAGCGCTTTGGCAAGGCAGAGGATATCCGGCTGTACGTTCTCATGCTCGCAGGCGAACATCTTGCCCGTGCGCCCCATGCCCGTTTGTACTTCATCGAGGATCATCAGTGCGCCGAACCTCGAGACGCTTGGAATTACAGGT
>neg_control_3052093:3052243	ACCTGTAATTCCAAGCGTCTCGAGGGTCGCCGTCGCGCATTTCACACTCGTTTTCGGTGTAGTGCAGAATGCAGCCGTTTTCACCGCTGCCGACAATGGTGTTATAGGACGGATAGCGCGCACCGTGGCGGTTAAATTCGTGGTGAATTTCGCCTTCCAGATGGTACTCGAACAGCTAGCGGTGTTTAGTTAGCATCC
>neg_control_1701216:1701366	GGATGCTAACTAAACACCGCTAGCGCAATCCAGGTAATGGAGTTGATTGAGCTGGGCATCGAATCCGCCAAACATCGCGCGACTTTGTGCCTTGCATGAAAAATGGATGGTGCATTTGCACCATCCATTTTGTTACTTCGCGGCGACTTTTTCTCGCAGTGCGCGTTTTTCCTCCTCGAGACGCTTGGAATTACAGGT
>neg_control_3823441:3823591	ACCTGTAATTCCAAGCGTCTCGAGCTGCAATATCTCCTTCGGCGGTCGGCGGATGATGACCTGCCAGATCAGCGACGGTTCCGGCATCCTCACCATGCGCTTTTTCAATTTCAGCGCGGCAATGAAAAATAGCCTGGCGGCGGGCCGCCGTGTACTGGCTTATGGCGAAGCAAAGCTAGCGGTGTTTAGTTAGCATCC
>neg_control_1689341:1689491	ACCTGTAATTCCAAGCGTCTCGAGAGCTCTTAACGTTCCGGCTGTACCGGCAATTCCGCAGCAGTAATTCACGGCCAAAACGCCGGAGAATTTTCACTCCGGCGTTTTCATCTGAAAACAAACCAGAGATTGCCTGATGCGCTACGCTTATCAGGCCTACCTTTTCCTGCAACAGCTAGCGGTGTTTAGTTAGCATCC
>neg_control_446326:446476	GGATGCTAACTAAACACCGCTAGCTGTGCGGTAACCGGTGAGTTCGATAGCGGCGCAGCGATCCTGCTGGCTATCTTCAGCCTGTGGCAGATGCCTCACTCCTATGCCATCGCCATTTTCCGCTTTAAGGATTACCAGGCGGCAAACATTCCGGTATTGCCAGTGGTAAAAGGCCTCGAGACGCTTGGAATTACAGGT
>neg_control_2584473:2584623	ACCTGTAATTCCAAGCGTCTCGAGACGAGGCCAAGCGTCGTCTGGAGGTGTTGTATCAGTGTTCGCAGGCGCTGAACACTAGCCAGATTGATGTGCATTGTTTCCGCCATATTTTGCAGATTGTTCGCGACAATGAAGCGGCTGAATATCTGGAGTTAAATGTCGGTGAAAACTGCTAGCGGTGTTTAGTTAGCATCC
>neg_control_536741:536891	GGATGCTAACTAAACACCGCTAGCCCGCGTTGCTGGAATAGTTTTCTCTGATGTTCCATAAATCCCTCTTAATTTCACGTATCGAATAACGTTGTTTTAATCTAGCTATGAGGAACAAATAAAATAAAAATATTATTTTTAATACTGAAGCAACATCTTTGGCTGCTTTCTTTTCTCGAGACGCTTGGAATTACAGGT
>neg_control_268275:268425	ACCTGTAATTCCAAGCGTCTCGAGATTTTTTCAATCCTCTGCGCTTGAGGCAGCTGCGCGACTGCTGGCTCAGGCAATGAATGAGTTATAATAGCAGCATTTACTAACAGGGATTTATTGAGAGTATGAGCCGCCGTGATACACCTTAAAATCTCAACCCAGCAAAGTTTCGGAGCTAGCGGTGTTTAGTTAGCATCC
>neg_control_2456702:2456852	GGATGCTAACTAAACACCGCTAGCCGCTTGCCTGGGTGGTGGGCTGGAGTTGGCGCTGGCGTGCCACGGTCGCGTTTGTACTGACGATCCTAAAACGGTGCTCGGTTTGCCTGAAGTACAACTTGGATTGTTACCCGGTTCAGGCGGCACCCAGCGTTTACCGCGTCTGATAGGCTCGAGACGCTTGGAATTACAGGT
>neg_control_4462472:4462622	GGATGCTAACTAAACACCGCTAGCACACCTGGACTATCTGCATAAACTGGGCGTTGATGCCATCTGGCTAACCCCCTTTTATGTCTCTCCCCAGGTCGATAACGGTTACGACGTAGCGAACTATACGGCGATTGATCCCACCTACGGCACGCTGGACGATTTTGACGAACTGGTCTCGAGACGCTTGGAATTACAGGT
>neg_control_2263746:2263896	GGATGCTAACTAAACACCGCTAGCGGTGCGGTTTCAACGATTTCCAGATCAACGGTCTGCGGCAGCTCAAGCGCCAGCAGTTGACCGTCCCAGGTCAGCACCTGCATGTCCGGCATGCCGCCCTCTGGCATAAACAGCAACTCTTCTTCAATCTGATCTTTGGTGAAGGTATACCTCGAGACGCTTGGAATTACAGGT
>neg_control_76398:76548	ACCTGTAATTCCAAGCGTCTCGAGCGTTAACTTCGTCGATTAATGCCCGGTAACCGAAGAAGTCATCGAATGCCTGAATTTTCAGTTGATTGGTGCTGTTGCGAATCACCGCATACGGACCGGTGCCGATGGGATGGCTGGCAAAGTTACTGAGGGTTTCCCATTCGCGCGGCAGCTAGCGGTGTTTAGTTAGCATCC
>neg_control_178190:178340	ACCTGTAATTCCAAGCGTCTCGAGTCGGCATTACCTCCACGCCAGGCAATCACCAGATCGGGTTTCAGCGCGACAATGCGTTCCAGATTCATCCCCTGCCAGGTGGAAACCTGCTCAATCTTTTGCGCTTGTGGAGGATAGTCGGAATAGCTGCTGACCCCAACCGGCGTGATCGCTAGCGGTGTTTAGTTAGCATCC
>neg_control_659991:660141	ACCTGTAATTCCAAGCGTCTCGAGCTTCTAAAGAGAGTAGTGGATTTCCCTCGCGGCAAATTAACACCATATTGTCGGTGAACAGAACATGATGTTGCACCGTACGATTGGTGCAAAACATGTTATCGATGATGAGATCGGTTTGAAACTGACTGAGTTGGTTTTCCGCGTCGCGCTAGCGGTGTTTAGTTAGCATCC
>neg_control_864152:864302	GGATGCTAACTAAACACCGCTAGCTCTGCGCGGCTTTGATTTTGACGGCCAGGAGGCGCTGAAAGATTCTCGCGTGCTGATAGTGGGCCTGGGCGGCCTCGGCTGTGCAGCCTCGCAGTATCTGGCAAGCGCCGGTGTCGGTAACCTGACGCTGCTCGACTTCGACACGGTTTCCTCGAGACGCTTGGAATTACAGGT
>neg_control_3496499:3496649	ACCTGTAATTCCAAGCGTCTCGAGAGTGGTGCTGGTTGGTGCAGGTCCGGGCGATGCCGGGCTGCTGACACTGAAAGGACTGCAACAAATTCAGCAGGCAGATGTGGTGGTCTACGACCGTCTGGTTTCTGACGATATTATGAATCTGGTACGCCGCGATGCGGACCGTGTTTTGCTAGCGGTGTTTAGTTAGCATCC
>neg_control_1270417:1270567	ACCTGTAATTCCAAGCGTCTCGAGTATGGGCAGACGGTTTACCGTGATGCGGGTCGTCATCATCACTGTCATCTTCGTGCTCGTAGACAAACAAACTTTGATGCGTTTTGGTCTGGATCAGCAAAAATACGCCATACATTGCCGCAGAAATTAATGCTACCAGTAACGCCTGACGCTAGCGGTGTTTAGTTAGCATCC
>neg_control_3567841:3567991	ACCTGTAATTCCAAGCGTCTCGAGTTAACAGGGCGTGAATGCTGTCGCGCCGCCGTTCAACCAGGTCAAGAGAACCGCCTAACCCTTCTTTACCATGATTGTTACTGTAATTGTTGTTGGTCCCGTCGCGATTTTCTTCTCCGTTTGCTTCATTGTGTTTATGGTTGAAGCAAAGCTAGCGGTGTTTAGTTAGCATCC
>neg_control_112973:113123	ACCTGTAATTCCAAGCGTCTCGAGGTTTTTCTCTTCCGGGTTGGCGAAGATCCGCTCGCGCAAGGCCCGGCGCTGCAATGTTCCATCAGCAGCAATCATGTTAGCGCCAAAGTGATCAGCAATGGCATGTAGCGCAGGTGCACCTGGTTCAACCACCTGACGCGCAATAATATCGCTAGCGGTGTTTAGTTAGCATCC
>neg_control_343194:343344	GGATGCTAACTAAACACCGCTAGCCAGGCACTATCAGAAATCGCTCATAACTAACGTGTGAAGTATTGTGTACTGGAGGGCGTTAATTTAACAATTTAAATTTACGTTATAGGTTTTACTGCTACTTTGATATTATTTCGCTCTCCTTAACTAAAAAGTTAAGTGGAGAGCGAACTCGAGACGCTTGGAATTACAGGT
>neg_control_1337671:1337821	GGATGCTAACTAAACACCGCTAGCCCCCGTCTCTTTCTGCCAGTGTGAACGCAAATATTGTGGGATATTTTTCTCTTCAGCCAACTGTTCTTTCACTAGATTTCCGCGTTCTGCTCGCTTTAAAGTGTAGAACTCATCAACCGGAATATGATGTGTTTTTTCCAGCCAGATAACCTCGAGACGCTTGGAATTACAGGT
>neg_control_2921793:2921943	ACCTGTAATTCCAAGCGTCTCGAGGTATTTCCAGCATTAGCTCGCATCATCCGCAAAAAGAGCATCCAGTTTTTCCAGCTCAGCCAGAATAAGCGCGCGTTGCGGATGGTCCGTCGCCAGCGCCATTTCATAATAGGGTGCAACGGCAAAAGCGCCCGGTAACGGCTGTTTGTTGCTAGCGGTGTTTAGTTAGCATCC
>neg_control_1551302:1551452	ACCTGTAATTCCAAGCGTCTCGAGGCGTTAAAGACATTCTTCGCGTATTGCAGGGCGAGGTTACCCAGACCGCCAAGACCGTAGATAGCAATCCACTGCCCTGGACGAATTTTTGACAGCTTAACGGCTTTGTAGGTGGTGACTCCCGCACAGGTAATGCTGCTGGCCGCCGCCGCTAGCGGTGTTTAGTTAGCATCC
>neg_control_2770493:2770643	GGATGCTAACTAAACACCGCTAGCCATGGCAGATCGTTATTTTCTCACTGGGCATGTACATCGTGGTCTATGGCCTGCGCAATGCAGGGTTCACGGAGTACCTGTCTGGCGTGCTGAATCTGCTGGCAGACAAGGGGTTATGGGCAGCGACGTTCGGCACCGGCTTCTTGACGGCTCGAGACGCTTGGAATTACAGGT
>neg_control_3909920:3910070	GGATGCTAACTAAACACCGCTAGCGCGGTCAGTTGTATGTCTTCGCCGATCAGGATGCGGGTTTTGTAAGTAGCGATAACATGCACATCATCGAGATGCCGCATGTGGAAGAGGTGATTGCACCGATCTTCTACACCGTTCCGCTGCAGCTGCTGGCTTACCATGTCGCGCTGACTCGAGACGCTTGGAATTACAGGT
>neg_control_4160266:4160416	ACCTGTAATTCCAAGCGTCTCGAGCGACCTTGTGCGTCTGGCTTAATGTTTCCAGATTCTTGCATAACGTTTCCGGGTTACAGGAGATGTACAAAATACGCGGATACGCCTGCACCATTTTCTCGGTTTCACTGTCCAGACCGCTGCGCGGAGGGTCGACAAAAATGGTTTCGCGCTAGCGGTGTTTAGTTAGCATCC
>neg_control_288802:288952	ACCTGTAATTCCAAGCGTCTCGAGTCTCTTTGGCCTCGCCCATCGACACCCACACGTCGGTATAGATAAAGTCCGCGCCCTTAACGCCTGCCGCCACGTCTTCCGTCAGAGTAATTTTCCCGCCGTGCTTCTCCGCCAGCGCGCTGCACTCCGCCACCAGGCTCTCTTCCGGCCGCTAGCGGTGTTTAGTTAGCATCC
>neg_control_2082972:2083122	GGATGCTAACTAAACACCGCTAGCACTCTATTGCTGAGACTTTTAATTTGTCTGTGTGGCCGTTGGTTGCCGTTTTGCTGGTGATAACGCTCTGGGTGGTGATGAAAGAGTTGAAGAAGCCAAAACTCAAAGTCGCGACCTTACCGCCGCGCCGAACCGGGATCGCTCATATTCCTCGAGACGCTTGGAATTACAGGT
>neg_control_1322769:1322919	ACCTGTAATTCCAAGCGTCTCGAGATGGCAGGGAAGTTTCGCTGCATTTTGCTGTTGATAGCAGGGCTGTTTGTATCATCTCTAAGTTATGCAGAAAACACGGAGATCCCTTCTTATGAAGAAGGGATCTCGCTCTTTGATGTTGAAGCCACTCTGCAACCAGATGGGGTGCTCGCTAGCGGTGTTTAGTTAGCATCC
>neg_control_2378010:2378160	ACCTGTAATTCCAAGCGTCTCGAGGATTCAGTCGACGACTGGCAGCCATCATCGCCGCCGCGTTGACCGGACTTGCGAAATGCAGGTCAGTTGCCCGAGCGAGCACCACTTTGTCGAGCTCACCTTCGGCGATGGTTTTCGTTGCCAGTTCGATTAATTGCGTCCAGCCCGTTTGCTAGCGGTGTTTAGTTAGCATCC
>neg_control_987797:987947	ACCTGTAATTCCAAGCGTCTCGAGGACGGCACCAATCAGGTTTGTGCGCGGACGCAGGTGAGCGACTTCACGCAGATACTCAATGCTGTGGCGTTTTGCCGCCATCGGGTAAGTGTCTGGATCTTCAACCCAACCAGCAACTTCAACCTTGCTGGCCTGAATTTCAAATTGTTGGCTAGCGGTGTTTAGTTAGCATCC
>neg_control_410472:410622	GGATGCTAACTAAACACCGCTAGCGCCCTGCTTTCGTTTGCTGCGATGTCGTCGTTGCTGCTGTATGGTCGCTATAAGCGCCAGCAAGCGGCGGATACTCCGGTGCTGGCGAAACCACTGGGGTAGGTTATAGTCTCGGTGCTCATTACTTATTGCCGGATGCGGCGTGAACGCCTCGAGACGCTTGGAATTACAGGT
>neg_control_2084344:2084494	ACCTGTAATTCCAAGCGTCTCGAGTCATGCCGCCGATCAGCGCGGTCAGGAAAATCGCACGCGGGATCACGCGCTCTGCATCTTTGGTTTCTTCCGACAGGTTGCTGATGCCGTCAAAGCCGGTAAAGGAGAAGCACAGGATTGTCGCCCCGGTAATCATCGGGATAACATGCGGCTAGCGGTGTTTAGTTAGCATCC
>neg_control_1941962:1942112	ACCTGTAATTCCAAGCGTCTCGAGACGGCATTGACGATTGGTGTAGCGATGAAATTTGTCGGTGCGTTGATTATTACTTCGTTGCTGATTATTCCTGCTGCTACTGCGCGTCGCTTTGCCCGCACGCCGGAACAGATGGCTGGTGTCGCTGTTTTGGTGGGGATGGTGGCAGTGGCTAGCGGTGTTTAGTTAGCATCC
>neg_control_1147214:1147364	ACCTGTAATTCCAAGCGTCTCGAGGATTGAGCGTCCGGCGCTGGTGACGGTATTACCACATCAGCAAAAGGGCAAAACGGTGGTCCTTGACTTAGGGGCCAACGTCGATTGTGACAGCACAATGCTGGTGCAATTTGCCATTATGGGCTCAGTTCTGGCTGAAGAGGTGGTGGAGCTAGCGGTGTTTAGTTAGCATCC
>neg_control_3473754:3473904	ACCTGTAATTCCAAGCGTCTCGAGCTGGAAATCACCGCTCTTGAACTGGCGGATGTAGAGATAGACAGTGTGTTTGGAGATGTTCAGGCGGTCAGCAACCTGGTTGATCGCATCTTTAATATCGAAGATCCCTTTCTCGTAGAGATTCAGCACGATCTGACGATTTTTGGCGTTGCTAGCGGTGTTTAGTTAGCATCC
>neg_control_1810081:1810231	ACCTGTAATTCCAAGCGTCTCGAGGGTCGGTATTGTTACCGTTAGTTCCGCAGGCGTTGCCGGTGTCGGTGGTGGTGCAACTTTCGCCGCACTGATTGTACTGCCTGCGATGGGCCTGCCAGTAACCCTGGTGGCGCTGTTAATCTCCGTTGAACCGCTTATCGACATGGGCCGGCTAGCGGTGTTTAGTTAGCATCC
>neg_control_4428735:4428885	ACCTGTAATTCCAAGCGTCTCGAGGTTGAACTGTTCGTGTTGGTAGGGCTGCCTGCTGCCGCAAGCGTGATCAACTTTGTGGTGCTGACCTCTGCGGCGTCTTCCGCTAACAGCGGCGTCTTCTCTACCAGCCGTATGCTGTTTGGTCTGGCGCAGGAAGGTGTGGCACCGAAAGCTAGCGGTGTTTAGTTAGCATCC
>neg_control_2270898:2271048	ACCTGTAATTCCAAGCGTCTCGAGTTAGCTAAACCCGGCAAAGAAGATATGCTGAGTCTGTTTTCGCTGCCGGTATTTCCAGAAAAGTACTGGAAGGATCACAAACTTAGCGACCCGCTCGCCACGCCTCCGCTTGCCAGTGGTCCGTACCGCGTTACGTCCTGGAAAATGGGGGCTAGCGGTGTTTAGTTAGCATCC
>neg_control_2653080:2653230	ACCTGTAATTCCAAGCGTCTCGAGCATCCGGCATATTAGTTTACGCCGTTAACAGATTAGCTATCGTGCGCACACCAAGTCCCGTAGCGCCCGCAGACCACTGTTCAACCGGCGCTTTACGGTAAGTCGCCGAGCAGTCGATATGCAGCCAGCCTTGCTGATAGTTCTCAACAAGCTAGCGGTGTTTAGTTAGCATCC
>neg_control_145824:145974	ACCTGTAATTCCAAGCGTCTCGAGGCGTATCCTGTGTTGAAACAATATGGCATGAAGGCGACGGCGTTTATTGTTACCTCACGCATCAAACGTCACCCGCAGAAGTGGAACCCAAAATCGCTGCAATTTATGAGCGTTTCTGAGCTTAACGAAATTCGCGATGTATTTGATTTCGCTAGCGGTGTTTAGTTAGCATCC
>neg_control_1024124:1024274	ACCTGTAATTCCAAGCGTCTCGAGCCGACTGGAAGAATTCGATAACTGCCGTGAGGCGTGGCGTAAATGTCAGGCCTGGTTGAAAGATATTGAAAGCGCTCGGTTGCAGCATAACCAGGCGTATACCGAAGCCATGCTTACCGAGTATGCGGATTTTTTCCGCCAGGTCGAGTCGCTAGCGGTGTTTAGTTAGCATCC
>neg_control_1190654:1190804	ACCTGTAATTCCAAGCGTCTCGAGTGCCATCTCTTTACCGATGGTTGACGGCGTGGCTGGCTGACCGTGGGTACGAGACAGCAGCGGGATATCGCGATACTGAACGGCGAGATCTTTAATGCCATCAATCAGTTGACGCCAGTATGGCAGGATCACTTCATCACGCGCGGTTTTGCTAGCGGTGTTTAGTTAGCATCC
>neg_control_2740429:2740579	GGATGCTAACTAAACACCGCTAGCTTGCTGCTGTCAGTGCCAGGTTTTTTTGCGCGTACTGTTTCAGGGTCAGCACCGAGGTCACGGAAAGCAGCAACCAGATCAGCATCATAGTGATAAATATGCTGGTCATACTGATGTTGCGTAATGCTCTTTTAAACGTGGGGCGCTTATCTCGAGACGCTTGGAATTACAGGT
>neg_control_405803:405953	ACCTGTAATTCCAAGCGTCTCGAGCCAGAGAAACGGCGGCGCTGGAAGCGGTAACTGCGCCATCCACCGTTATCGCTACAGGCGGCGGCATTATTCTGACGGAATTTAATCGTCACTTCATGCAAAATAACGGGATCGTGGTTTATTTGTGTGCGCCAGTATCAGTCCTGGTTAGCTAGCGGTGTTTAGTTAGCATCC
>neg_control_983600:983750	ACCTGTAATTCCAAGCGTCTCGAGCGCCTTATCCGGCCTACAAAATCGTGCAAATTCAAAATATTGCAGGGGACGCGTAGGCCTGATAAGCGTAGCGCATCAGGCAATGTTGCGTTTGTCATCAGTCTCAGCCCGCTTTTCAGCGGGCTTCATTGTTTTTAATGCTTACAGCACGCTAGCGGTGTTTAGTTAGCATCC
>neg_control_935255:935405	GGATGCTAACTAAACACCGCTAGCAGTGCGGCATTTTCGCCAGATCGGCAACCACCGGCTCACCGGCGATATCTTTACCCAGCACCACGGTTAATGGCGACGGATTATCGCGGAATTTGGCGTTATCCAAAACTTCGCGCAGATAAACGGTTTGTCGTTTTTTATTCGGTAACTCTCGAGACGCTTGGAATTACAGGT
>neg_control_3128623:3128773	GGATGCTAACTAAACACCGCTAGCGGGCCTTCATGCCAAAGTGCCACTGATTGCCTTTCTTGGTCTGATGCATCTCCGGATCGCGTTGCTGCTCTTTGTTCTTGGTCGAGCTGGGTGCCTCAATGATGGTGGCATCGACCAAGGTGCCTTGAGTCATCATGACGCCTGCTTCGGCTCGAGACGCTTGGAATTACAGGT
>neg_control_2968763:2968913	ACCTGTAATTCCAAGCGTCTCGAGACGAATCCATTGAAGGTGAAGAAGAAGGGCTGAAAACACGCGTTTCATCATTCCTCGGCGCTATCGTGCAGATTATGCTGCTGGATATTATCTTTAGCCTCGACTCGGTGATTACGGCTGTGGGTCTGTCAGATCACCTGTTTATTATGAGCTAGCGGTGTTTAGTTAGCATCC
>neg_control_1699470:1699620	ACCTGTAATTCCAAGCGTCTCGAGAAATTATGCTCCTGTGTAGCCCACAGAATCCTACCGGGAAAGTGTGGACGTGCGATGAGCTGGAGATCATGGCTGACCTGTGCGAGCGTCATGGTGTGCGGGTTATTTCCGATGAAATCCATATGGATATGGTTTGGGGCGAGCAGCCGCGCTAGCGGTGTTTAGTTAGCATCC
>neg_control_2412739:2412889	ACCTGTAATTCCAAGCGTCTCGAGAAATCGGCGGTAACGAAAGAGGATAAACCGTGTCCCGTATTATTATGCTGATCCCTACCGGAACCAGCGTCGGTCTGACCAGCGTCAGCCTTGGCGTGATCCGTGCAATGGAACGCAAAGGCGTTCGTCTGAGCGTTTTCAAACCTATCGGCTAGCGGTGTTTAGTTAGCATCC
>neg_control_84787:84937	ACCTGTAATTCCAAGCGTCTCGAGATACATGTTATGTTCAAGTCTTCATTAAATCAGAACACTGAACATCAGCTGCGTTATCAGGAAACGGAGTTTGTGATTAGTTATGAAGACTTCCATCGTCCTGAATTTACCAGCGTACCATTATTTAAAGATGAAATGGTGCTGGTAGCCGCTAGCGGTGTTTAGTTAGCATCC
>neg_control_4208524:4208674	GGATGCTAACTAAACACCGCTAGCTTAACCTTGCTACAGAATATAAGTCGCTGACCCATTATACAAAAGGTACGCAGTCACACGCCTAAGCGTGCTCCCACTGCTTGTACGTACACGGTTTCAGGTTCTTTTTCACTCCCCTCGCCGGGGTTCTTTTCGCCTTTCCCTCACGGTCTCGAGACGCTTGGAATTACAGGT
>neg_control_2259214:2259364	ACCTGTAATTCCAAGCGTCTCGAGTGCGCAACTGCCCGGGAAATATCGCCCAGCCAGACATTTTTACCGTTCAGCGCGCTGTCGTTCGGGATGGAATCACCGAGAACAATCGCCATTTCAGCGTCGTTCGGATTGTCGATGATTTCCAGTTTTGCTTTTCGCGCCGCCGCGCCCGCTAGCGGTGTTTAGTTAGCATCC
>neg_control_1007469:1007619	ACCTGTAATTCCAAGCGTCTCGAGCGGATATCCGCGTTAACGTCTGGCTGCATAAAGAAACCGCCAGTATCGCTCTTGATCTGAGTGGTGATGGTTTACATCTGCGTGGCTATCGCGATCGTGCTGGTATTGCGCCGATCAAAGAAACCCTGGCAGCCGCTATTGTGATGCGATGCTAGCGGTGTTTAGTTAGCATCC
>neg_control_2543149:2543299	ACCTGTAATTCCAAGCGTCTCGAGCCAATTTTCATCAGTTTGAACGACAGATCGCGCCCCACCAGCGCCGATCCGCCCAGGCCCGTTATCTGGATAAACGGTGCTTTACTGATGACCTCAATGATTTTTTGCAGCCGCGCGTAATCGAGCAACGCGCAGGTTTGCTCCAGCGCCGCTAGCGGTGTTTAGTTAGCATCC
>neg_control_4600553:4600703	ACCTGTAATTCCAAGCGTCTCGAGGAATTTGGCTAAATCGTTTCTCTACGCCTTTGTAATCCAGCAGATGATGCTCCGCAAGAATCACAATGTGCTGGACTTCAGTCACCACATGCATATTAATGCCGCGATCGTGATTTTTACGTGTCGATGTCAGGCATTGCCCATCTTTAAGCTAGCGGTGTTTAGTTAGCATCC
>neg_control_2229158:2229308	ACCTGTAATTCCAAGCGTCTCGAGTGATCATTCCTTTTTTAATGCTGACTGGCATCTCTTACGACAGCTACTTTAAAGGTAGCGAAGTGCTAAACGATCTGCTGCAACCGGCGGTCGTCGCGCTGGCCTATCCTTTATATGAGCAGCTACACCAGATCCGCGCGCGCTGGAAATGCTAGCGGTGTTTAGTTAGCATCC
>neg_control_4144139:4144289	GGATGCTAACTAAACACCGCTAGCTGATGTCATCCTGGATCTCCTTCGACAGTTCGACAAAGAAGGCGCTGTATCCGGCAACGCGCACCACCAGCCCGGCATAATCTTGTGGGCGCTGTTGCGCTTCCCGCAACGTGTCGGCGTTCACCACGTTAAACTGAATATGTTGTAACTCTCGAGACGCTTGGAATTACAGGT
>neg_control_2063173:2063323	GGATGCTAACTAAACACCGCTAGCGGGCGGGTAAATCAGCAGTTGGCCGCTGCGGCAAATGAAGTATGGCTGGTGGTTTCGGGTATTGGAGTAAAAATCAAATGAGTAAATTATTTTGGGCGATGCTCTCATTTATTACGCGTCTGCCTGTACCGCGTCGCTGGTCCCAGGGACCTCGAGACGCTTGGAATTACAGGT
>neg_control_181571:181721	GGATGCTAACTAAACACCGCTAGCTCTGCGAGGTCAGGTTTTTCACCATGTTACTCGGGATAGCAAAACCGATACCGATGTTGCCGCCGTCCGGTGCGAGGATCGCGGTGTTGATACCGATCAGTTCGCCGTTCAGGTTAACCAGCGCACCACCGGAGTTACCACGGTTGATCGCTCGAGACGCTTGGAATTACAGGT
>neg_control_4019511:4019661	GGATGCTAACTAAACACCGCTAGCACTGTCGTAAACCAATTCAGGCAGTTCTGGCATTTTTTCGACCCAGAACGGCGCTTTTTCTTTAAATGCTCTCACCAGCGCAGGAATACCGACCTGATCTTTAATCCACGACTCCAGGAAAGGCTTCGCCGTTTTCCATAAATCGAGTTGCTCGAGACGCTTGGAATTACAGGT
>neg_control_1803584:1803734	GGATGCTAACTAAACACCGCTAGCATAACGGCTATCGAGAGCGCGATGTGTTGACCGCGGGTTATGGTCGTCAGTTTTTGAATGGCCCGGTACACAGTTTCCGCTTTGAATTCGGTCCAGGTGTGCGTTACGACAAATATACCGACAATGCCAGTGAAACCCAGCCGCTGGGCTCTCGAGACGCTTGGAATTACAGGT
>neg_control_762891:763041	GGATGCTAACTAAACACCGCTAGCCCAGACCTGCGCCGTTAACCATACAACCGATGTTACCGTCCAGCGCAACGTAGTTCAGTTCCCACTGTGCAGCCTGTGCTTCACGCGGATCTTCCTGCGACTGGTCACGCATTTCGCGCAGATCAGGCTGGCGGAACAGTGCGTTGCCGTCTCGAGACGCTTGGAATTACAGGT
>neg_control_1358119:1358269	ACCTGTAATTCCAAGCGTCTCGAGCTTCGCCATAAAAGTGGCGTGCATCTTATGCTTTTCTGCCATCAGACGCACCAGGCGTTTTAGTGCCAGCGCATCATCGCAGGCTTCCAGCACGTTATCAGTATGGTAAAGGTTGATTTCAAACTGACCCGGCGAGGCCTCAGCGACCGCGCTAGCGGTGTTTAGTTAGCATCC
>neg_control_2791268:2791418	ACCTGTAATTCCAAGCGTCTCGAGTCCTTGCCCGCTGCACGGCATAAGCGAGGATGACGCTATCGCCAGCATCCACCGGATCTTCAAAAATGATGCCGCGCCGGAAGATATCGCCGCCATCGTGATTGAGCCGGTTCAGGGCGAAGGCGGTTTCTACGCCTCGTCGCCAGCCTTGCTAGCGGTGTTTAGTTAGCATCC
>neg_control_2545811:2545961	ACCTGTAATTCCAAGCGTCTCGAGCCGGCCTGCTGGGCGTTGGTGAACCGCTGATTTACGGTGTCACCCTGCCCCGCATGAAGCCGTTTGTTACCGCCTGTTTAGGCGGCGCGGCGGGCGGTTTGTTTATCGGCCTGATAGCCTGGTGGGGTCTGCCGATGGGCTTAAACAGCGGCTAGCGGTGTTTAGTTAGCATCC
>neg_control_2993563:2993713	ACCTGTAATTCCAAGCGTCTCGAGAAATGTAATATGGACATTCCATATTGATTTGTCGACAAAATATGACTCTACTTCAAGAGACTTATCTTTGAAACTGGTAGGTATATGGAGATTTACAGGACCTGATATTGATGGTAATTTTGTTACCCAACTTTCAAAAATTTTGATAAAGCTAGCGGTGTTTAGTTAGCATCC
>neg_control_1324556:1324706	ACCTGTAATTCCAAGCGTCTCGAGATTACAGACGCACCTAAGTTGCGGGGCCAATACCAGTTTGTTGGGGCGAAGTTATTCCGGTGGTGGTGCTGGCGGCGGCGCGGGTGGCGGAGGCGGTGGTGGCTGGTAATTAAGCTGATGTTAATCGAAACAAGCTTTAACCATAAAGATGCTAGCGGTGTTTAGTTAGCATCC
>neg_control_3680705:3680855	GGATGCTAACTAAACACCGCTAGCTTTACCATCGGTAAATACGGCGTCGGCACACTGGTGCAACTGGGGCAGCTGATTATCTGTTTCTACATTACCTGTATCCTGTTTGTGGTGCTGGTATTGGGTTCAATCGCTAAAGCGACTGGTTTCAGTATCTTCAAATTTATCCGCTACCTCGAGACGCTTGGAATTACAGGT
>neg_control_133828:133978	ACCTGTAATTCCAAGCGTCTCGAGCCGCCAACCCGTATGGACGCCGCACAGTTGACCGAAGAAGGCTACTACAGCGTCTTCGGTAAGAGTGGTGCGCGTATCGAGATCCCTGGCTGTTCCCTGTGTATGGGTAACCAGGCGCGTGTGGCGGACGGTGCAACGGTGGTTTCCACCGCTAGCGGTGTTTAGTTAGCATCC
>neg_control_1724858:1725008	GGATGCTAACTAAACACCGCTAGCGAAATGCGTCCGGTGTGCCACAGCTGCACGGCCATATGACCATTTTCAGCATGAACGCCAGCGGTGATTTTTTTCCATGCGGCAATTTGCTCCGGACTATGGATGCCAGGCGCACCTGCATATCCTTTTGCCTGGGCAGAAATTTGCGTGCTCGAGACGCTTGGAATTACAGGT
>neg_control_415561:415711	ACCTGTAATTCCAAGCGTCTCGAGGTCCAGCGTGCCAATATAAATGTCACGCACGGCGTCACTTTTACTGGCCCCCACGGTCGTTAAATGTCCCGTGGCGATGATGGGCAGAGGCTGATCGCCGCGCAGTTTGCAGGCATCGGCATAGTGTTGTTGGTAATAATCGGTAATCGCGCTAGCGGTGTTTAGTTAGCATCC
>neg_control_217908:218058	ACCTGTAATTCCAAGCGTCTCGAGGCTGCCTTCAACCGCTTTAACCAGCAGAGTCTTAACCGTTTTCTCAATCGGCAGATTGAACTGTTCAACCAGTTCCGCGATGGTTTTCGCGTTCGGCGTATCAACCAGCGTCATTTCCTGGGTAGCAGCAGCGCGCGGTTCTTTCGGCGCGCTAGCGGTGTTTAGTTAGCATCC
>neg_control_2964515:2964665	GGATGCTAACTAAACACCGCTAGCGTGCCGTCAATGGTATTTATGCTGCCGCATCTGGCAAAGCGGGTCGATTTCATCTCTGTTGGCACCAACGATCTGACTCAATACATTCTGGCCGTTGATCGCAACAATACCCGGGTGGCGAACATTTATGACAGTCTTCATCCTGCAATGCTCGAGACGCTTGGAATTACAGGT
>neg_control_2815500:2815650	ACCTGTAATTCCAAGCGTCTCGAGTTAAACCTGCATAACGCTCGTACATGGTCTTCTCGCAAGTCGAAAAATATGACGCTACTTTAGCGTAATTGCTTGATTTTGTCGCTGATGGCGAAGGAGAAGAAAATTCAGGAAATGGATAAAGGAGTTATTTAGAAATGAGATATTTTTGCTAGCGGTGTTTAGTTAGCATCC
>neg_control_346602:346752	ACCTGTAATTCCAAGCGTCTCGAGCTGATGCCCGCCGACGCGGGTGACCTCTTTTTCTTCCAGCACCCGCAGCAGCCGGGTCTGCAAAGGTAGCGGCATTTCGCCAATCTCATCCAGAAACAGCGTACCGCCGTGGGCAATTTCGAACAGCCCGGCGCGACCTCCGCGTCGCGAGCTAGCGGTGTTTAGTTAGCATCC
>neg_control_2366125:2366275	ACCTGTAATTCCAAGCGTCTCGAGCGGTTACGAAATTAGCGCCATTTTTACCCATACTGATAATCCCGGTGAAAAAGCCTTTTATGGTTCGGTGGCTCGTCTGGCGGCGGAAAGAGGCATTCCGGTTTATGCGCCGGATAACGTTAATCATCCGCTGTGGGTGGAACGCATTGCGCTAGCGGTGTTTAGTTAGCATCC
>neg_control_3982553:3982703	ACCTGTAATTCCAAGCGTCTCGAGTGAATCCACCCTGATATCCGCTCTGGGTATAAGCGTAAGGTTGCTGAATCAGGACGTGATACTTGAACTCATCCATACGCACAGCAGCGAGTTTACCGTTGAGGAAGTAGTGCTCGGCCTTACGGTTAGACTGACCATTTGTTCCCAGGAGCTAGCGGTGTTTAGTTAGCATCC
>neg_control_3476017:3476167	ACCTGTAATTCCAAGCGTCTCGAGAGCAACCGTCGTGGTCGTGATCGTGGTGGTGATCGTGCGCGCCGTGAACGTGACCATGAGCCAGTTCTTCTTCAGTCGCTTCGCGAATCGCCACAACTTCAACGTTGAATTTCAGGTTCTGACCGGCCAGCATGTGGTTACCATCAACCAGCTAGCGGTGTTTAGTTAGCATCC
>neg_control_3105360:3105510	ACCTGTAATTCCAAGCGTCTCGAGGCTTTTTGTAGGTCTTTGACGTCGAAACTGACATACAGATCGTGCATCTCCTGACACAACTGGCGCAGGGTGTAGTCGCGATAGCGCACCGGATACTTGTTATAAACGCTCGGCAACACCTCAACCAGCGGCGAGTCATCCTCAATATGCGCTAGCGGTGTTTAGTTAGCATCC
>neg_control_2363058:2363208	ACCTGTAATTCCAAGCGTCTCGAGCCATCCAGATAAACTTTGCCTTTTTCCACATGCATGACTAAACCATCCAGATAATCAGGTTTAAATGTCGCGTCACGCTTATCTTTAGCAATATATGTCAGGCAATGATTATGGGTGAAAATAACGATATTTTTATCAGGCGCTTTGCTTGCTAGCGGTGTTTAGTTAGCATCC
>neg_control_479004:479154	ACCTGTAATTCCAAGCGTCTCGAGGCGTAATGTGTGCTCTTCCGCCAGGGAATGATTGTATCGGTGAATAAGCTGACGAGCGCGCAGGCGATCGCGAGATAACGTCTCATCTGCCGAGCGATACAACTCACCAGCAATCATCTTTTCTTTTTCTGTGCTCATTACTGACCTCCGGCTAGCGGTGTTTAGTTAGCATCC
>neg_control_78249:78399	ACCTGTAATTCCAAGCGTCTCGAGTGGCTGGCAGGATAGTAACGTACGGATGTTATTTGTCGCCTCGACGTTAATGTGGACCTGCAACACCATGTACATTATTGATATGCCGTTGTGGATCAGTAGCGAGTTAGGATTGCCAGACAAACTGGCGGGTTTCCTGATGGGGACGGCGCTAGCGGTGTTTAGTTAGCATCC
>neg_control_271997:272147	GGATGCTAACTAAACACCGCTAGCAGCAGCCGTTGAATCCGTAGGGACGGATCGGTGGCTGCCCATGTGGCAAGCTTGCGTTGCATTTCGCTGATTATCAAAGGTCTTCACCTCGTTAGGTCAGTTAATTCACGTCGCAAACACATTCAAACTGCTTCCCTTCGCCATGTAATGCTCGAGACGCTTGGAATTACAGGT
>neg_control_3808555:3808705	GGATGCTAACTAAACACCGCTAGCGCTGATGGATAACAAGCTGGTGGTAGGGGTAGGGAATATCTATGCCAGCGAATCACTGTTTGCGGCGGGGATCCATCCGGATCGGCTGGCGTCATCACTGTCGCTGGCAGAGTGTGAATTGTTAGCTCGGGTGATTAAAGCGGTGTTGCTCTCGAGACGCTTGGAATTACAGGT
>neg_control_655984:656134	GGATGCTAACTAAACACCGCTAGCGCCAGGTACTTTCCCATCCGTATCCGGCAATCGGTTCCCATTTGTTCCACGAGTCCTTAAATGCCATGGCATACAGGCCATGCCAGTTTCCTTTTTCATCCCAACGCGACAGGCCAAAACCGCCACCCCACGGTCGCTCGTTATAGCGATCTCGAGACGCTTGGAATTACAGGT
>neg_control_2420563:2420713	ACCTGTAATTCCAAGCGTCTCGAGGCGGGTTTTGCGTTTCGCTGGTACGATTTAGAAGAGGCGCTGGCGGATGTCGTTCGCTGATGTGGTTTACAGCAAACATCCGCCAGTTAACTCCCGGTGTTACAGGATTAGTGGCTTTGCGCGATAAGATCGTCTGGTGAAAGTCGGGTCGCTAGCGGTGTTTAGTTAGCATCC
>neg_control_1791431:1791581	GGATGCTAACTAAACACCGCTAGCTGTCTATTGTGATGCAGTTACAAGATGTTGCGGAATCTACCCGCCTGGGGCCGCTTTCTGGCGAGGTTCGGGCTGGGGAGATCCTGCACCTGGTGGGGCCGAATGGCGCGGGTAAGAGTACCTTACTGGCGCGAATGGCCGGAATGACCACTCGAGACGCTTGGAATTACAGGT
>neg_control_4180450:4180600	GGATGCTAACTAAACACCGCTAGCTATCATCGACTTCGCCTTTACCGTTACGGATATCGATGAGCTTTTTCATAACATCAATGATGTCGTCTTTGCTCAGGATACCGGAACCTTCGATTTCTTCGCGCAGCAGAGAACGGTTGAACTTCATACGACCAACCGCAGACAAGTCATCTCGAGACGCTTGGAATTACAGGT
>neg_control_1933996:1934146	ACCTGTAATTCCAAGCGTCTCGAGAATGGTGATACGATTTTTTTGATCCAGCATCGCGCCGAGACGGCTGAATGCAGCAGTGTCATTGACATCGAGATTACAAAAATCCAGACGTGCACTCAGGGTGTCCCATAAACCTTCATCAATGGTTTCTTTCATGAAAGTTTCGAGCGCGCTAGCGGTGTTTAGTTAGCATCC
>neg_control_2981148:2981298	GGATGCTAACTAAACACCGCTAGCAACGAATAAGGTATTGTTATGATTTTAAGTGCATTTTCTCTCGAAGGTAAAGTTGCGGTCGTCACTGGTTGTGATACTGGACTGGGTCAGGGGATGGCGTTGGGGCTGGCGCAAGCGGGCTGTGACATTGTTGGCATTAACATCGTTGAACTCGAGACGCTTGGAATTACAGGT
>neg_control_3474828:3474978	ACCTGTAATTCCAAGCGTCTCGAGCTTCTGTCCAACCCGGGATAACACCGTCCAGACGGAAAGAAAGCGGTTCACCACGGGTGTAAGAGTTGTCGAACTCTTTACCGTCGATCAGCGTACCTTTGTAGTTCACTACAACAGTATCGCTGTCTTTCGGTGCTTCGCCTTTACCGGGCTAGCGGTGTTTAGTTAGCATCC
>neg_control_3615187:3615337	ACCTGTAATTCCAAGCGTCTCGAGGGCATTTTGCCCGCTGGCGTTCGCCAGACGGCGGGGGAAATTTTAGCCGATGGCAAACCGGTTTCGCCTTGCGCCCTGCGCGGCATCAAAATTGCCACCATCATGCAGAACCCGCGCAGCGCCTTTAATCCACTGCACACCATGCACACCGCTAGCGGTGTTTAGTTAGCATCC
>neg_control_4593362:4593512	ACCTGTAATTCCAAGCGTCTCGAGGAATGTGTTTCGAGCATTTCGCGTAGCTCAAACAGCTGCTCGGCGTAGGATTGATCGAATTGCTTCATGCTCCACTGGCCGCGCTTTTCGCTGTGAATAAGATTATAACGGCCGAATTTTAAAAGATATTCTCTTACTACAACCGGGCTGGCTAGCGGTGTTTAGTTAGCATCC
>neg_control_4467100:4467250	ACCTGTAATTCCAAGCGTCTCGAGGCGAGATTGTGCCGCTCGATGACATCATGCTGCGTAAGATTAAGCGGGTTACTGATACGCTGAATCGTCAGGGGCTGCGCGTGGTTGCGGTGGCGACGAAATACCTGCCAGCGCGTGAAGGAGATTACCAGCGGGCGGATGAATCCGACCGCTAGCGGTGTTTAGTTAGCATCC
>neg_control_887638:887788	GGATGCTAACTAAACACCGCTAGCGCCGGAATTATGCTGGGCTTTATGCGTGCTAACCACCCGACCTTCGGTTACATTCCGCAGGGTGCATTAAGCATGGTGAAAGAGTTCGGCTTGATGGTGTTTATGGCAGGCGTTGGTCTGAGCGCCGGTAGCGGTATTAATAACGGCCTGCTCGAGACGCTTGGAATTACAGGT
>neg_control_2191489:2191639	GGATGCTAACTAAACACCGCTAGCTTATCTGGTCACTGACGACAATGCGATGGTGTGGCGTGGACCGATGGCGAGCAAGGCGTTAATGCAGATGTTGCAGGAAACCTTGTGGCCGGATCTCGACTATCTGGTGCTTGATATGCCGCCAGGCACCGGTGACATTCAATTGACGCTCTCGAGACGCTTGGAATTACAGGT
>neg_control_3812866:3813016	GGATGCTAACTAAACACCGCTAGCTCACAGAAGGCCAGGATCTGGCTTGCCAGCAGGGTTTCATCGGTGGTGTAACCTTCACCCTCACGCATTCTCTTTTCACGCAATACCTGGCGCAGCTGCGCTTCAATACGCTCGAACAGCTGGTTGATGCGCCCTTGCAGGCGATCCTGTCTCGAGACGCTTGGAATTACAGGT
>neg_control_2373177:2373327	ACCTGTAATTCCAAGCGTCTCGAGTAAGCTCGATTCAATGGAAGAACTGATCACCGCCGTCAGCCCCAGCGCGTGCGCCGCCTGTACCTGCTCGCGTACTTTTTCCAGACTGCCCGTGAGCGTGGGTTTGATAACTACCGCGCGCACGCCCTCTTCAGCCACAAAGGCAAAATCGCTAGCGGTGTTTAGTTAGCATCC
>neg_control_2907234:2907384	ACCTGTAATTCCAAGCGTCTCGAGGCAAGGATTCGATATCACCTACTGTACCGCCGATTTCTACCAGTACTACGTCATGACCTTCGCCACCTTCCAGCACGCGCTCTTTGATTGCGTTAGTGATGTGCGGAATAACCTGCACGGTTGCGCCGAGGTAGTCACCGCGGCGTTCTTGCTAGCGGTGTTTAGTTAGCATCC
>neg_control_2339824:2339974	ACCTGTAATTCCAAGCGTCTCGAGCACGTTGGAAAGATAAGTCAGGCTGTCAGTTTCAAGGTTGGTATTAAGCTCACCTGTCAACGTCACACCATCGGTGGCATTCACCAGCGTCCCATCGCCGTTAAATAGTGAGGCATTAAGGGCGACGGAAGTATCCTGCCCGGTCAGGCGGCTAGCGGTGTTTAGTTAGCATCC
>neg_control_1345738:1345888	ACCTGTAATTCCAAGCGTCTCGAGCACAAATGTTAGCGGCAATCATCGCTTCTTCGACGATACGGTTGGCAATGCGACGAGGCTCGGCGACGATATCCAGCACTTCACCTTTTTCACCGAGAATAAAGCGGTAATCCGGGCGATCTTTAAACACCAGTGCGTGGTTATGACGCCGCTAGCGGTGTTTAGTTAGCATCC
>neg_control_1822187:1822337	GGATGCTAACTAAACACCGCTAGCCGTGATCAAACCCGGCGGGTGTCCGAATTAACGTTGTCGCTTCTTCCAGCGAATTAACCGCCCCCAGCCACAGCCAGTTTTGAATAATATGATATTGAGTCATTTCCGGGTGCTGTTCTTTCAGCGCCACCGCCCCTTGCCAAGGCCAACCTCGAGACGCTTGGAATTACAGGT
>neg_control_3825632:3825782	GGATGCTAACTAAACACCGCTAGCGCGCTGCCGATGCTGGCGATTCTGGTGGTACAGACCATCTTCATGGCGTTGTATGCCATCTTCGTTACCTGGCGCATGATGGGCAAAAACTACGATGCGGCAGTGCTGGCTGCGGGTCACTGTGGTTTTGGCCTCGGTGCAACGCCAACGCTCGAGACGCTTGGAATTACAGGT
>neg_control_3404192:3404342	GGATGCTAACTAAACACCGCTAGCTCAGAACCCGGTACGCAAGGGACGCCCGCTTTTTTCATCGCCGCGATTGCGGATACTTTGTCGCCCATCAGGCGAATGGTTTCTGCTTTCGGGCCAATGAAGATAAAGCCGGAGCGTTCAACCTGCTCGGCAAAGTTGGCGTTCTCGGAGCTCGAGACGCTTGGAATTACAGGT
>neg_control_1552809:1552959	ACCTGTAATTCCAAGCGTCTCGAGTCGCTTAACTGACCACCTGCCGCGCGGCTTGCTGCGATCAGTGTGCCGACTGTTACCGCCGCAGTGCCCTGAATGTCATCGTTAAAAGAACAAATTTCATTGCGATAGCGGTTAAGTAACGGCATCGCATTTTTTTGAGCAAAGTCTTCAGCTAGCGGTGTTTAGTTAGCATCC
>neg_control_4438364:4438514	ACCTGTAATTCCAAGCGTCTCGAGTATCCGGCACAATCAGCGTGTTGCGAATTTGTACGCCGCTGTTCAGTGCCAGGCTTTGGTTAGCCAGCACGCGGTTCAGCAGGTCTTTAGAATCGACATAACCGATGATGTGGTCAATATCTTCATTACAGACGAGGAACTTAGAGTGCGGCTAGCGGTGTTTAGTTAGCATCC
>neg_control_882282:882432	GGATGCTAACTAAACACCGCTAGCCGCTATCGCGCTGGCGGTCAGCCTGTTTGTGTCCTGGACGATGGGACATCTTTTTCCGCACGACCGACCCTTTGTCGAAAATATCGGCTATAACTTCCTGCATCATGCGGCGGATGACTCATTCCCAAGCGATCACGGTACGGTGATTTTCTCGAGACGCTTGGAATTACAGGT
>neg_control_2111471:2111621	ACCTGTAATTCCAAGCGTCTCGAGGCTTCTCAATACCTTTACGGAACTTCGCCCCTTCTTTCAGGTTGCGTAGGCCATACTTCACAAACGCCTGCATATAGCCCATTTTTTTGCCGCAGTCGTAACTGTCGCCGGTCATCAGCATTGCATCAACGGATTGTTTTTTCGCCAGCTGCTAGCGGTGTTTAGTTAGCATCC
>neg_control_4485330:4485480	ACCTGTAATTCCAAGCGTCTCGAGGAGCGGTGTGATGCAACCTTTTGGCGTACTTGACCGCTATATCGGTAAAACTATTTTCACCACCATCATGATGACACTGTTCATGCTGGTGTCGCTGTCGGGCATTATCAAGTTTGTCGATCAGCTGAAAAAAGCCGGGCAGGGGAGTTAGCTAGCGGTGTTTAGTTAGCATCC
>neg_control_1920524:1920674	ACCTGTAATTCCAAGCGTCTCGAGCAACGTCCTTTTGCCATTCATAAACATCATCTGGATAATCGGCATGAGCAATAACATGCTTGCCGGTGCGACTGTGTACTTCAAGAATAAAGGGCAAATGCTGACATTTTTCCAGCGCCGTTTTCGCTTGTTTCTGTTGATTATCTGCCAGCTAGCGGTGTTTAGTTAGCATCC
>neg_control_1340568:1340718	ACCTGTAATTCCAAGCGTCTCGAGCAGGCGTTGTCGGCTGGTGTTGATTATATGGTGATTGGTCGCCCGGTAACGCAATCGGTAGATCCAGCGCAGACGCTGAAAGCGATCAACGCCTCTTTACAGCGGAGTGCATGATGAGTGATTCCAACAGCCGTCTGGTCTACTCAACGGGCTAGCGGTGTTTAGTTAGCATCC
>neg_control_4107304:4107454	GGATGCTAACTAAACACCGCTAGCCAAAAGTGTTAGTGGAGCCACGCGCGCCAGAATCCAGAACTTCGACGTTTTTATACAGTGCCCGAACAAAATCCTGTGCTTTTGCCTGATCGTTGTTGTTGTGATGCAGCGCGTAGCCCCAGGCTGCCAGGTAGTTCCAGCGCGCGCCACCTCGAGACGCTTGGAATTACAGGT
>neg_control_86943:87093	GGATGCTAACTAAACACCGCTAGCGATCATGTCCTGCCACTGCTTCACCATCCCCAGATAGCGGTTATTGAGATTCACCACCAGTACGGGCAACTCGTATTGCAACGCGGTAGACAGTTCCTGGATGTTCATCTGAATACTGCCGTCGCCAGTGACGCAAACCACGGTTTCTTCCTCGAGACGCTTGGAATTACAGGT
>neg_control_3491200:3491350	ACCTGTAATTCCAAGCGTCTCGAGGGGGATCGGCGTACTGTTTCTCTCTGTTGCGGCGTTGTGCTACATCCTCGGTCAGTTAGGTTTTATCTCCTGGGTGCCTGAGTATGCCAAAGGCCTGGGCATGAGCCTGAACGACGCGGGCACGCTGGTGAGTAACTTCTGGATGTCATAGCTAGCGGTGTTTAGTTAGCATCC
>neg_control_3927896:3928046	ACCTGTAATTCCAAGCGTCTCGAGGCAAAGCCGATACCGTTCAGTTTACCGCGAATTTCACCACCTTTGCTCAGCCACTGTTCCAGCGCGCTACGCTCAAAGGAGATATGAACCACTTCCATATCATGCAGTTTTAACGGTTTTTGCAGCAGTAGAGTCAGAGTGGAAGCAGTAGCTAGCGGTGTTTAGTTAGCATCC
>neg_control_5682:5832	ACCTGTAATTCCAAGCGTCTCGAGTTAACGCTGCTCGTAGCGTTTAAACACCAGTTCGCCATTGCTGGAGGAATCTTCATCAAAGAAGTAACCTTCGCTATTAAAACCAGTCAGTTGCTCTGGTTTGGTCAGCCGATTTTCAATAATGAAACGACTCATCAGACCGCGTGCTTTGCTAGCGGTGTTTAGTTAGCATCC
>neg_control_2808198:2808348	ACCTGTAATTCCAAGCGTCTCGAGTTTCCTGCTCGCCTCTTTCCAGCGCAAACAATCTCTTTGCGTTACCGCAGCGTTAGTTGGTGCCCTTGCAGGCGTAACGCTATTTTCTATTCCCGTCGCCATTCTGGCAGGCATTGTCTGTGGCTGCCTCACTGCGTTAATCCAGGCATTGCTAGCGGTGTTTAGTTAGCATCC
>neg_control_1241786:1241936	ACCTGTAATTCCAAGCGTCTCGAGACAACGTGCCTTCGGCCCGACATGTCGGGCCTTCCCCTTGCCATTCAATGGTGAAGGTTTCATTGCGTAACGCCAGCCAGAAATGGTGCTCGGTAAAGGCGTTCAGTTCATCCGCGCCAAAGTTTGCTACCAGCATGGGGCCGCTAAAGGGCTAGCGGTGTTTAGTTAGCATCC
>neg_control_608246:608396	ACCTGTAATTCCAAGCGTCTCGAGTTTGCTGCACCTGGATGCTTTGCGTGCAAAGGAACCTGAACTCGCGAAAGCGTGGATATTTGCTAATCTACTCGCCGCATTTTTAATTGACGACATAATCCAGCCATCGCTGGATTTCCCCCCCAGAAGTGCCGGATCCGAAAAGAAGAAGCTAGCGGTGTTTAGTTAGCATCC
>neg_control_3573820:3573970	GGATGCTAACTAAACACCGCTAGCTTATTGAACAACTGAACTACTCCGGTGCGCAAATGGCGGCGCTGTCGATTTGTATCGCTGGTGGTTCGATTGTTGTCAGCCACGTTAACGACGCCGGTTTCTGGTTGTTCGGTAAATTTACCGGCGCGACCGAAGCCGAAACGCTGAAAACTCGAGACGCTTGGAATTACAGGT
>neg_control_4574282:4574432	ACCTGTAATTCCAAGCGTCTCGAGATGGACCACTGTCGCAGTTTGGGCAACGCTTCTGGGACGTGCTGTTTAACGACCATGAAGAAGCGCAGTCACTGATGAATAACACGCGAATTACCGGCGTTCACTATACCGATCGCTATCTGCAAAACCCGGTTGCGCTGGCGTTGTTGGGCTAGCGGTGTTTAGTTAGCATCC
>neg_control_4308638:4308788	ACCTGTAATTCCAAGCGTCTCGAGATTTCTCGCCAGTCGATAATATTGACGCCACAGATTTTTTTCGTCAGATGACGACCAATATATAAATTTTCCAGTACGGTTAATTCATCAATAACGCTGAGTTCCTGATAAATAATCCCGATACCGAGTTGTGCCGCTAATTTATGATCCGCTAGCGGTGTTTAGTTAGCATCC
>neg_control_1832587:1832737	GGATGCTAACTAAACACCGCTAGCCACCACGTTTTTCAACCGCACCATAAGTGTATGTTGCATTGCTGACGATGCCGACCGGGCAGCTATCCAGACACACCAGGCAACCCGTTTTCTTCTCTTCTGCTGCCGTTAAATTACCGCCAAAGCGCATGTCCAGTTTCTTGCCATTACCTCGAGACGCTTGGAATTACAGGT
>neg_control_318428:318578	ACCTGTAATTCCAAGCGTCTCGAGATACCGGCATTTTCTGGATGTAACGAAGCGGTAGCCGGTTGACGACCGGAAGCTATTAACAGTGCATCCACCGCCAGTTGGGCGTGCTCGCTATGCACTTGCACTTGATTTTCATGGTGACTGATTCGCTCCACATGGGCATTGAGGATAGCTAGCGGTGTTTAGTTAGCATCC
>neg_control_1349443:1349593	ACCTGTAATTCCAAGCGTCTCGAGGACCGGCGGTTCAGTTCCTGCAGAATATTCTCCAGCACCGTCTCCTCATTACAATCAATCTCGTTATTCCAGAAACGCAGCACGGTCCAGCCCTGCGACTCAAGCCAGCTAGTGCGCCTGGAATCATAGGCAACTGCTAAATCATGCTGCGCTAGCGGTGTTTAGTTAGCATCC
>neg_control_1100151:1100301	GGATGCTAACTAAACACCGCTAGCGCCGGGGTTTTCCGCTTTATTGACTACCAGCGCTTGCTTGAAGGGGAAGTGGGTTACACCTCGAACGAACCTGTTATGCTGTGCCTGATGTCGGCTATCGAAACAGGGGTCATTTTCCTGATTAATGATGGTATCGACCGTGGTCTGTGGCTCGAGACGCTTGGAATTACAGGT
>neg_control_2972912:2973062	ACCTGTAATTCCAAGCGTCTCGAGCCGGAGGTAAAAAGGATCAGCGCCTCTTCTTCCGGCTGCTGTTTAACCTGTGCCAGACGCGGCATCAGCAAATGAGCGAAGATCCATACTTTGTCGGCAGTGGTGACATCTGCTTTTAAATCTTCCAGATAGACCCAGCGCACCTGAGTAGCTAGCGGTGTTTAGTTAGCATCC
>neg_control_1894425:1894575	ACCTGTAATTCCAAGCGTCTCGAGCCGCCGCGCTGCGCGAAGCTGAAGAAGAGGTCGCTATACCGCCTTCCGCCGTTGAAGTTATCGGCGTGCTGCCGCCCGTCGATAGCGTCACTGGCTACCAGGTAACCCCAGTGGTCGGCATTATCCCGCCCGATCTGCCGTATCGCGCCAGCTAGCGGTGTTTAGTTAGCATCC
>neg_control_158028:158178	ACCTGTAATTCCAAGCGTCTCGAGCAGACGTTTCGGGATTGCCAGTGAACGGCAGGCTTCGTCCAGCACGTCGTTCATCGCCAGCGCGAAAGCGTCGTGATAGGTCAGGCCGCTTTCCTGGGCGATCTTCTGTGCCGTCTCCAGCAGTGGGTACCAGAACATGGCGGCAAACAGGCTAGCGGTGTTTAGTTAGCATCC
>neg_control_4152238:4152388	ACCTGTAATTCCAAGCGTCTCGAGTCGTGCATTAGTTCGATAGCGTTAACTCCGCGTGCTGGATCGCTGGAGTGCCCCGACTGGCCCTGAATACGGATGGCGTTAGAGATATGACCTTTATGTGCGCGTACCGGTTGTAGTGACGTCGGTTCGCCAATGATGGCGCAATCCGGGGCTAGCGGTGTTTAGTTAGCATCC
>neg_control_671738:671888	ACCTGTAATTCCAAGCGTCTCGAGGGCCAGCAGTGCTTCCTGCATCAGAGCGCGATCCTGCTCGCCATCGGTTGGTGCTTTCGCCAGTTTGTTCATCAGCTCCATAATCGCCGCAATTGCGGTGTTGAAGGTCTGACGACGGCCGATATCATCGGTCACTTTAGCGATCGTTTTGCTAGCGGTGTTTAGTTAGCATCC
>neg_control_2429281:2429431	ACCTGTAATTCCAAGCGTCTCGAGTTACCCGTCGGTGCAGCTTTTTCTTCCACGACCGGCTTCGGTTCTGGCTTCGGCGCAGGTGGTGCTTCAACCTTTGGTTTAGGCGGCTCCACCGGTTTCGGCTTCGGTGGGGCGACCGGTGCAGGTTCCGGTTCAAACTCGGTGTTATTGGCTAGCGGTGTTTAGTTAGCATCC
>neg_control_241794:241944	ACCTGTAATTCCAAGCGTCTCGAGGGTCAGAATGTTAGCCCCTTCAACGGTGATGGCAATCGGTGCGCCCTGGTAAGCACGCGCCAGGAAGTTGCTTTGCCCGAGCATAATGCCTTTACCGCCGGTAATATCCATCGCATCAATAATCGACTGCTGCCCGCGGTGGGTACAGTGGCTAGCGGTGTTTAGTTAGCATCC
>neg_control_3602911:3603061	ACCTGTAATTCCAAGCGTCTCGAGCTGTTCCAGCAAACTGGTCATTACATCGGGAAAAAGTGGCGGGTCAGGTGGCTTATCGGCTGTATCAACGCGAAGCACAAGGAGAAAGTGATGCTGATTAATATTGGTCGTTTGTTAATGCTCTGCGTTTGGGGATTTTTAATCCTCAACGCTAGCGGTGTTTAGTTAGCATCC
>neg_control_3190445:3190595	ACCTGTAATTCCAAGCGTCTCGAGTGCTTACTGGCTGGTTTTTTTGGTCTTATTGGCATCCTGTTGCAGCATGCCTGCATCATGGTCTGGCAATCACCACTGTCGAACCTGTTCGTGGTTCCTGTCAGTTTACTGTTTACGATTATTGCGGTGCATTATACCGGTAAAATAGTTGCTAGCGGTGTTTAGTTAGCATCC
>neg_control_4441785:4441935	GGATGCTAACTAAACACCGCTAGCTCACGTTGTACTGGTATTCCAGCGATCCGGTTATCAACTTCGAGGCCCCTTTCAGGTCACCGTTGGCGTATTTCGGAGCGATAGATTTGTATTTGTAGCCACGAATACTGCGGTCGCCCCCGGCGAAGAAACGCAGATCCGGCGGTACTTCTCGAGACGCTTGGAATTACAGGT
>neg_control_1108851:1109001	GGATGCTAACTAAACACCGCTAGCGATTTCATCGTTTTTATCTTTGCTGTTGATCGGGTAAAGCACTTTAAAACCGGCAAAGCCAAGGTCTTTTACCGTATCTTTGTCATGCTGAACATCGCCGAAAGTGAAATAATCCGGGCTGTATTTGATTCGTTTGACTGCGGTGGCAGTCTCGAGACGCTTGGAATTACAGGT
>neg_control_708502:708652	ACCTGTAATTCCAAGCGTCTCGAGAGGCTGACGGTCAGCAGGGATACTTCCTGCAACGTATGACTCCAACCTACGCTTCCTCAAACGGTCGCCTGGATATCTGGTGGGATAACCGTTCTGACTTCAACGCCAACGGCGAAAAAGCGGTCTTCTTCGGTGCGATGTATGACCTGAGCTAGCGGTGTTTAGTTAGCATCC
>neg_control_249177:249327	ACCTGTAATTCCAAGCGTCTCGAGTTTATGCCGTTGATGAAAATGGCGTACTGACTGGGCTTAAGGCGGAAGTTTTCCCGAATGCGGATCTCCGGCAGCAGCACGCCGTTGCCGTCAGAAATCACCTGCCGCACGCCGCGAATCCGCTGGGTGAGCGGGTTACCCTGTGCTTTGGCTAGCGGTGTTTAGTTAGCATCC
>neg_control_1578059:1578209	GGATGCTAACTAAACACCGCTAGCTGAGAACACATTCCGTATCATTGATTTTTCTGTGCCTCCCACGGCTTATGGCAAGTTTATGTCAACCATTTTTATGCAATGGGTTAAAAACGATGTGGGTGAAATTTTCATCCGTCAGTTTGAAAGCTTTGTCAGCCGTTTTTTGGGGAACTCGAGACGCTTGGAATTACAGGT
>neg_control_1839836:1839986	ACCTGTAATTCCAAGCGTCTCGAGGGCGCTGCAATATCCGCTGGCCCCTGCTGACATTCCATTATTAGAGGCGTTTATGGCTTTACGCGCCGCCAGACCAGCGGATTAGTGCTAAGGGTTTTGTCATCACGCTGGCATTGCAGCAGTATTCCTTCGGCTTTAATTACCGCCCCTGCTAGCGGTGTTTAGTTAGCATCC
>neg_control_2894036:2894186	GGATGCTAACTAAACACCGCTAGCATGGGCAAACGCCATTTTTGCTGGCGGAAATGCTGGGCTGGCCCTGCTTCACCCAGGTGGAGCGTTTCACTCTCGACGCGCTGTTTATCACCCTCGAACAGCGTACTGAACATGGGTTGCGTTGTTGCCGGGTTCGCTTGCCTGCGGTGACTCGAGACGCTTGGAATTACAGGT
>neg_control_425782:425932	ACCTGTAATTCCAAGCGTCTCGAGCTTTGATGAGTGTACGCCGTATCCTGCTGACTGGGATTACGCAAAACGCTCCATGGAGATGTCTCTGCGTTGGGCGAAGCGTAGCCGTGAGCGTTTTGACAGTCTCGGAAACAAAAATGCGCTGTTTGGTATCATCCAGGGCAGCGTTTAGCTAGCGGTGTTTAGTTAGCATCC
>neg_control_3707585:3707735	ACCTGTAATTCCAAGCGTCTCGAGGACGTACAAACATGCAACGCAGTGAGAGTTTGGTTGCGGTATCACAGGAGTAACCACGGAACGCCGCCAGATTTTTCTCCTGGGCCAGTTTCGGCGTGGTATTACGCTCATAGCCGAAAATACCCATATGGTCCCAACGCGTGGTTTCACGCTAGCGGTGTTTAGTTAGCATCC
>neg_control_3150749:3150899	ACCTGTAATTCCAAGCGTCTCGAGGACGTTCCGGCGATTGTTGCCGCCGTACGCAGTGTGGTGCCGGATGCCATCATTATGATCGACAACACCTGGGCAGCCGGTGTGCTGTTTAAGGCGCTGGATTTTGGCATCGATGTTTCTATTCAAGCCGCCACCAAATATCTGGTTGGGGCTAGCGGTGTTTAGTTAGCATCC
>neg_control_1215677:1215827	GGATGCTAACTAAACACCGCTAGCATTTCCAGTGTTTTTCTAATCACATCAGCTTTGAGAATATCACTTGTTGTTTCCAAGGAGTGTATCAGACTTAAGATAATATTTTTATTATTAACATTATCGCCTGAAAGCATTAAATTGGTGACAGCCTGCCCTAACACTGCTGATTCTCTCGAGACGCTTGGAATTACAGGT
>neg_control_2101991:2102141	ACCTGTAATTCCAAGCGTCTCGAGTCAGATAATTTAATTTCTGGCCGACTGACAATGATGTTATTTATAGAATATTTCTTGATAAATTTTTCTTTCATCCAGAATTGTTGAACAAACACTGCAGTATTTTTTTTAATGTTTATTTTATATATCAGCCCGTATAGCATTTTAAATGCTAGCGGTGTTTAGTTAGCATCC
>neg_control_2402289:2402439	GGATGCTAACTAAACACCGCTAGCTTGAGATGGTGACTTCGTTTACCGCGGTGCATGACGTGGCGCGTTTTGGCGCAGAAGTATTGCGTGCTTCGCCGCGTCAGGCTGACCTGATGGTGGTTGCAGGAACCTGCTTTACCAAAATGGCACCGGTTATTCAGCGTCTGTATGACCCTCGAGACGCTTGGAATTACAGGT
>neg_control_4277095:4277245	ACCTGTAATTCCAAGCGTCTCGAGAAACTGAAAGTCCCTGGTGGCATTCTGCTGACCATTATCGGTATCTCAATTGTCGGTTTGATCTTCGATCCTAACGTCCATTTCTCCGGCGTTTTCGCCATGCCTTCATTGAGCGATGAAAACGGCAATTCACTGATTGGCAGCCTGGACGCTAGCGGTGTTTAGTTAGCATCC
>neg_control_3146619:3146769	GGATGCTAACTAAACACCGCTAGCATTTGCGCCATTGATTGTCCACGCTGCTGTGCCATTTCATTCAATAAGCGCAGGCTGTTGAGGTTGGCTTCGGTAAGCATTTTCGGTGTCAGACCACGAACTTTATTCCCTTCACGATGCATCCGTGAATCTTGCGGAATGCCGTTGAGACTCGAGACGCTTGGAATTACAGGT
>neg_control_1882918:1883068	ACCTGTAATTCCAAGCGTCTCGAGTCGTGATAAGGTTTTGCGCGCGTTCTATAACGTGTGTCCGCACCGTGGTCATCAGTTGTTGAGCGGTGAAGGAAAAGCAAAAAATGTGATTACCTGCCCGTATCACGCATGGGCATTCAAACTCGATGGCAACCTGGCCCATGCACGTAAGCTAGCGGTGTTTAGTTAGCATCC
>neg_control_30122:30272	GGATGCTAACTAAACACCGCTAGCTCCGCAGGATGTTGCGCTTGGCACCAAAATCATAAGCCACGACGTGGAACGGCAGCTCGTCTTCTTTTTTCGCTTCTGGCAGGCCACCGGTCAACGTCCAGCTCCCTTGTGTCCAGCTATAGGCTTCTGCGGTGGTCACTTCTTTTGCCACTCGAGACGCTTGGAATTACAGGT
>neg_control_4363694:4363844	GGATGCTAACTAAACACCGCTAGCTCAAAGATACCGCTGGTGAAGTGATTCAGGGTCATCCGTGGCTGCTGGCCGTCATCTTCTTCTTTGCTTCTGCTCTGCTGTACTCTCAGGCTGCAACCGCAAAAGCACTGATGCCGATGGCTCTGGCACTGAACGTTTCACCGCTGACCGCTCGAGACGCTTGGAATTACAGGT
>neg_control_444821:444971	GGATGCTAACTAAACACCGCTAGCTCGGCGTGCAGCTTTTCTTTGTGGCGTTTAATTTGATGGAAGCCCTCCTGCCCTCACTTATCAGTAAAGAGTCGCCAGCAGGTTACAAAGGTACGGCGATGGGTGTTTACTCCACCAGCCAGTTTCTTGGCGTGGCGATTGGCGGTTCGCCTCGAGACGCTTGGAATTACAGGT
>neg_control_1732789:1732939	GGATGCTAACTAAACACCGCTAGCTGCCACCCCAACGATATGGCTTACCAATTTGCTGCATCAGTTTATTCATTGCCACTTTCGTAGCTTTTTGCACCTTCGCTTTGTGCGCGTCGGCAAGAGTTCCTGACGCGGCATTTTTGACTTTCACACAATGCGATTTATAGCCCTTACCTCGAGACGCTTGGAATTACAGGT
>neg_control_2385128:2385278	ACCTGTAATTCCAAGCGTCTCGAGTTTTGATCCCGCGAAGAATGATCCGCTGAGTCGTGCCGTGCTTGGTGAACACAGCCTCGAAGATGGCATAGATGGCTTCCTTGGATTGACCTGGAATCAGGAGTTAGCCGCGACAATCGACCGACTGGAATCACTGGATCGAAATGAACTGCTAGCGGTGTTTAGTTAGCATCC
>neg_control_469605:469755	GGATGCTAACTAAACACCGCTAGCTGATTGCCACGCTGGGCGATATGTCCGTGCTGCATCACAATAATTTCACTGGCTTCCGTCAGTGCAGAAAGGCGATGGGCACTGATGATTACCGTTCTTCCCTGCCCCCACTGACGCAGGTTATGCAGGATCTGGTGCTCAGTGCGTCCGCTCGAGACGCTTGGAATTACAGGT
>neg_control_4040773:4040923	ACCTGTAATTCCAAGCGTCTCGAGCAGTTCGAAGCTGATAATATCGATCAGATGGAAGCGGTTGGGCGTTATTTAGGGCGTATGCACCAGACGGGGCGCAAACAGCTTTTTATCCATCGCCCGACCATCGGTTTGAACGAATATCTCATTGAGCCACGCAAGCTGTTTGAGGACGCTAGCGGTGTTTAGTTAGCATCC
>neg_control_1945761:1945911	GGATGCTAACTAAACACCGCTAGCGGTTACGGTCCTGGCGGCACGGCAATCATGATTGAATGTCTGTCTGACAACCGCAACCGTACCGTTGCTGAAGTGCGTCATGCATTTAGCAAATGTGGCGGTAACCTCGGTACTGATGGTTCCGTTGCCTATCTGTTCAGCAAAAAAGGCCTCGAGACGCTTGGAATTACAGGT
>neg_control_4375220:4375370	ACCTGTAATTCCAAGCGTCTCGAGAGGCTGCTGTACCCAAATAAATTTACTGACATCAAACCCTTCCCGGGTCGCGACTGCCAGCATCTCCTGTTTCACTTCGTCAGAAATGGTTGGCGTGCGGGAGAGTATCCACAGGTAGTCGCGGTCCGGGCCGCAAACCAGCGCATGGCGGCTAGCGGTGTTTAGTTAGCATCC
>neg_control_3815121:3815271	GGATGCTAACTAAACACCGCTAGCATCTTCCAGCTTCGCGACCAGACGCTCACGCTGCCATTGCAGGATTTCCGGCATATGGGAGCGGACTTTGACCACTTCGGCGGTGACGCCTTCCAGACGCTGCTCGATCAATGCTTTCAGTGCCTGACCTTCGGTTTCGCGCGCGACAATCTCGAGACGCTTGGAATTACAGGT
>neg_control_3837274:3837424	ACCTGTAATTCCAAGCGTCTCGAGGAAATTCCTTCACGTTTTCTGCATTCTTATTATCTTCCCGTGCCACCAAAATATTCACATACGGCGAATTCTTATCTTCAATAAATACGCTGTCGTGCACCGGAGAAAGCCCGGTCTGCTGAATGTAAGTGGTGCTGATAATCGCTACATGCTAGCGGTGTTTAGTTAGCATCC
>neg_control_3674516:3674666	GGATGCTAACTAAACACCGCTAGCAATCTGAATATTGCCAACGGCGTGGCGCGCCCGCAGATTTTTGCTTTCGATACTGAGAACGCGTTGATTAATGTTACCGGCACGGCAAGTTTTGCTTCGGAACAGCTGGATTTGACTATTGATCCGGAGAGTAAAGGAATTCGGATTATCCTCGAGACGCTTGGAATTACAGGT
>neg_control_578511:578661	ACCTGTAATTCCAAGCGTCTCGAGTCGGAAAACTCCTGCTTTAGCAAGATTTTCCCTGTATTGCTGAAATGTGATTTCTCTTGATTTCAACCTATCATAGGACGTTTCTATAAGATGCGTATTTCTTGAGAATTTAACATTTACAACCTTTTTAAGTCCTTTTATTAACACGGTGCTAGCGGTGTTTAGTTAGCATCC
>neg_control_1288846:1288996	ACCTGTAATTCCAAGCGTCTCGAGGCGATCTCCATCTTGCTATTCGCGCATCATGCAGTATTCCAGGACTCATGGCACCTGTTGCACATAACGGCTACTGGCTGGTTGATGGAGCAGTCGTTAACCCAATTCCTATTTCCCTCACGCGTGCATTGGGGGCTGATATTGTGATAGGCTAGCGGTGTTTAGTTAGCATCC
>neg_control_3339368:3339518	GGATGCTAACTAAACACCGCTAGCAGGTGTACCGGTGCTGGCAAACGTTGCCGCCATTTTTCGCCCAATATGCCCCGATTTTCCCATCCCCATGACGACAACTTTCCCTTTACACCAGAACATCTTTTCACAGGCAAGCGTGAAATTCTGATTGATGTATTGATCAAGCTCCGCCTCGAGACGCTTGGAATTACAGGT
>neg_control_1692528:1692678	ACCTGTAATTCCAAGCGTCTCGAGCACTCCACATGTCGGTGTACATTGAGTGCAGCCCGGCTAACGTATCCACGCCGTATTCGGTGATGATAATCGGCTGATGCAGTTTCTCCTGCCAGGCCAGAAGTTCTTTTTCCAGTACCTTCTCTGCCGTTTCCAAATCGCCGCTTTGGAGCTAGCGGTGTTTAGTTAGCATCC
>neg_control_2175897:2176047	GGATGCTAACTAAACACCGCTAGCAGAAATTTCTGCGGCTTTTGAACGTGCGCACGAGCTGGGTATGGTGACAGTGCTGTGGGCCTATTTGCGTAACTCCGCCTTTAAGAAAGATGGCGTTGATTACCATGTTTCCGCCGACCTGACCGGTCAGGCAAACCATCTGGCGGCAACCTCGAGACGCTTGGAATTACAGGT
>neg_control_3577224:3577374	ACCTGTAATTCCAAGCGTCTCGAGATCCGGCGAGAGCACCAGCTGTTTGCCCTGTACGGCATCGAAGCGACGCTGTTCATAACGCGGCGTAATACCGTTTTCTTCAGGCATGATCCAGATCTGATACAGATGCAGACGCTCGGTGCTGCTTGGGTTGTACTCTGAGTGACGAATGCTAGCGGTGTTTAGTTAGCATCC
>neg_control_205633:205783	GGATGCTAACTAAACACCGCTAGCGGATCGCGACGCGGATTTCGTGTGCGTCAAAGTCGCTGCTGTCGATAAAGCGCACGTCGTTGGTCGCCACGACGGGCAAACCGCGCGCTTCCGCCAGTTCCACCGCCGCGTGCAGATAGCTTTCTTCATCCGGCCTGCCGGTGCGGATCACTCGAGACGCTTGGAATTACAGGT
>neg_control_3612330:3612480	GGATGCTAACTAAACACCGCTAGCAGTTGGGTGTGGTAAGCCGGATTCTGGCTAAAGCGGGCGAAGGTATCGAGCGGTAATAACCCTTCGTTTCCGTACAGCAGGTCGATATCGCCAGTTTCAAACGCCACCGCGCGGGTAGTCGGGTCCGGGATGACGTTAAAGGTGATCTTTCTCGAGACGCTTGGAATTACAGGT
>neg_control_432916:433066	ACCTGTAATTCCAAGCGTCTCGAGGTACGCCACCGTGCTGTGACGCACTCATCGCCGCTGGCGTAGCGCGCGTGGTTGCCTCGATGCAAGATCCTAACCCGCAGGTCGCTGGGCGTGGACTTTACCGTCTGCAACAGGCTGGCATTGACGTCAGCCACGGCCTGATGATGAGTGGCTAGCGGTGTTTAGTTAGCATCC
>neg_control_3524890:3525040	GGATGCTAACTAAACACCGCTAGCGCTCGATTTGCTCACTCTCTTCCCCGCGAATCGACGCCTGCGTTGACGGAACAGGTTGCAAGGCATAGCTGCGAGTTTCCTGCATGTACTCCTGCAGCGTATGACCGTTGAGTGAAATAACCAGCGGCAGCGAATCGGTATGAATCAGTTCTCGAGACGCTTGGAATTACAGGT
>neg_control_2053842:2053992	ACCTGTAATTCCAAGCGTCTCGAGTGCATGGAAAAAACATCAGATGCCAGCATGGCATTTAATTACCGCCGATGGTCAGGGTATTACTCTGGTGAATATTGGCGTGGGACCGTCAAATGCTAAAACCATCTGCGATCATCTGGCAGTGCTACGCCCGGATGTCTGGTTGATGATGCTAGCGGTGTTTAGTTAGCATCC
>neg_control_132407:132557	GGATGCTAACTAAACACCGCTAGCCACCTTTGTACGGGTAAACGTCAATCACGTCGCCCATGTTCAGGTTAGAGACGTCGACTTCGATTGGCAGTGCACCCGCGTCTTCCATCGTGTTAAAGAAGATGGGTGCAATTTTACCGCCGAGGCACAAACCACCGCCGCGTTTGTTCGCTCGAGACGCTTGGAATTACAGGT
>neg_control_1048124:1048274	ACCTGTAATTCCAAGCGTCTCGAGGTAGAACTCAGGGTCGCAGAGCGAAAATGGTTGTCTTCACTCCAGAGAATATCGCGCGTCCAGCGGCTGCCATCTTTTATTGCCAGCGCGTTACGCAGAGGGTCCTGCCCGGAATTTGTCACTTCCAGCAGATTATTATTAAGTTTGACGGCTAGCGGTGTTTAGTTAGCATCC
>neg_control_2912620:2912770	ACCTGTAATTCCAAGCGTCTCGAGACTTAAACGCGCGCGACGGCGATAGCCCCAGGGAACATCGGCGATCACTTCAGAGACATCGTGTTTCATTAATCGGGCGAGTGCCGCACTTTTGCTTCGCTGCTGTAAATCCACGCTGGCGTGTTGTTGCTGACAGCCACCGCATACGCCGCTAGCGGTGTTTAGTTAGCATCC
>neg_control_4474820:4474970	ACCTGTAATTCCAAGCGTCTCGAGCTTAAGTAATCGAGAAAAAACAAATTTAATACAAAGGCTATTTGATAATGTTGAGTCTATATTTAATGAAGTACCTGTCAGCATTTTAGTGAATGATATTTTTATGAATGATTTCTTTATGAAAAATCCTGAGATGATTAATTGGTACTTGCTAGCGGTGTTTAGTTAGCATCC
>neg_control_2089764:2089914	ACCTGTAATTCCAAGCGTCTCGAGCGAAGCGAAACGTCAGGTGAGCCAGCGTCTGGACGGTGCGGCGATCGATATGCCCGCAGGCCCGTCGGAAGTGCTGGTGATTGCTGACAGCGGCGCTACGCCGGATTTCGTGGCTTCTGATTTGCTCTCTCAGGCTGAACACGGCCCGGAGCTAGCGGTGTTTAGTTAGCATCC
>neg_control_4412842:4412992	ACCTGTAATTCCAAGCGTCTCGAGGGGAATGACGGAAAAGCAGGGCGGTTCCGATGTTATGAGCAACACCACCCGTGCAGAGCGTCTGGAAGATGGCTCTTATCGGCTGGTGGGGCATAAATGGTTTTTCTCGGTTCCGCAAAGCGATGCGCATCTGGTGCTGGCGCAGACCGCGCTAGCGGTGTTTAGTTAGCATCC
>neg_control_4360926:4361076	ACCTGTAATTCCAAGCGTCTCGAGTGTGGTTAACAGTTCGTGGGTGAAATCGTAGGCCGCGCTTTTTTGCTGATCGGCCAGTTGATGAATAGGGTGGCCAGGATCGGGATAAAACGTACAGGCAGCGATAAATAGACAGCCCGGATAGCGGTTGTTTTTAACGCACTCCGATAAGCTAGCGGTGTTTAGTTAGCATCC
>neg_control_2822053:2822203	ACCTGTAATTCCAAGCGTCTCGAGGATACCACTAATAGACACGGCATAATCAGCACGAGCCGCTTTCAGTGCGCCTATCGCCATTTCCACCACGACGGGTTCACTCACCGCGCCATGCTGCGCCAGCGTCTCTTCGCGTACGCCGATCATCTGCGCTTTGGCTTCGTTACTGTAGCTAGCGGTGTTTAGTTAGCATCC
>neg_control_3155005:3155155	GGATGCTAACTAAACACCGCTAGCGGCGTTGTTGCATCAGCGGATGAAGTTCGATCTGGTTTATCACAGGCGTCACGCCAGTTTCATCAATCAGGCGTTGCAGGTGATGGATCTGGAAGTTGCACACGCCGATGCTTTTGATTAATCCCTCTTTTTGCAATTCGATCATGCCTTCTCGAGACGCTTGGAATTACAGGT
>neg_control_3912569:3912719	ACCTGTAATTCCAAGCGTCTCGAGTTGCGGATGAACGGCGACGATTTCACGCCCTTCCTGATACGCCAGCGCAATAATGTCGGTGATGTAGTATTCGCCCTGAGCATTATTGTTGGTCAGCTTCGCCAGCCAGCGTTTCATATCTGCGCCGTTGGCAATCAGAATGCCGGTGTTGCTAGCGGTGTTTAGTTAGCATCC
>neg_control_2908275:2908425	ACCTGTAATTCCAAGCGTCTCGAGACGCATTAAAGCCGGTAAACTACGAGGAATATCGTCCAGCGCCGAATGCTGCGCTTTCTGCGCGCGCTCTTCGGTTTTGATTTGCTCCCAACGGGCAAGCACTTCACTACTGTTTTCGGCAGAACTATCAGCAAAAACATGCGGATGGCGGCTAGCGGTGTTTAGTTAGCATCC
>neg_control_622640:622790	ACCTGTAATTCCAAGCGTCTCGAGGATGACACCGGTTGCTTCCGCAAGCGCGAGCGGTTTTGGTTTGTTGATTATCGGCGTGTTGTTATTGCTGGTGCTGGTGGAGTTGCGACATTTTCGCCAGACGCCGCCGCAGGTGACAGCGTCCGACAGTTAATGCTTAAAACAGCGCCTGCTAGCGGTGTTTAGTTAGCATCC
>neg_control_3111636:3111786	GGATGCTAACTAAACACCGCTAGCATAGTTCTGCGTAAAGAAGCATTAGGCATGGGCGATGTATTACTTTTCGCCGCGTTAGGTGGCTGGGTGGGGGCATTGTCGCTGCCCAATGTTGCTTTAATCGCCTCATGCTGCGGCCTGATATATGCCGTTATTACAAAAAGAGGATCACTCGAGACGCTTGGAATTACAGGT
>neg_control_901688:901838	ACCTGTAATTCCAAGCGTCTCGAGTGTCACCGAAGACGCCGTCGATACGCCCGTTTTGCAGATCCAGTTTTGCGTTCTGGTAGCTGTCATACGGAACGGTAGTGATTTCCGGGTGCTTATCCATAATGAATTTCTGGTGTGTCGTCCCGTTCTGTACGCCGACTTTTTTGCCTTGCTAGCGGTGTTTAGTTAGCATCC
>neg_control_2257446:2257596	GGATGCTAACTAAACACCGCTAGCGTTATTTCCTCAAGGGCAGATTATTTTCTGCCCTTTTTTATTGTTCTGTTCTGTGCATCCCGTCACAAATTCCTCGCTTTTGTAATTCAGGCATTTAATCGCATTTTGTGAGCCTGCTCAAATCTGCCCATTTTGCCTCTCTGGCGGTAACTCGAGACGCTTGGAATTACAGGT
>neg_control_3571031:3571181	GGATGCTAACTAAACACCGCTAGCAGGTACTCACCTGCGCCCGTATGAAACCTTAGGCGCGCATGCAGATACTATGGATGGCGTCACAGGTACGCGTTTCTCTGTCTGGGCTCCAAACGCCCGTCGGGTCTCGGTGGTTGGGCAATTCAACTACTGGGACGGTCGCCGTCACCCCTCGAGACGCTTGGAATTACAGGT
>neg_control_1975566:1975716	GGATGCTAACTAAACACCGCTAGCACCGCCGAAAGGCATGCTGCCATTCTCAACCGACTGGTTTATGACCTGGGAACAAAACGTTCATGCTTCGATGTTCTGTAATGCATGGCAGTTTTTACTGAAAACCGGTTTGTGTAATGGCGTCGATGCGGTGATCAAAGCCTACCGTTTCTCGAGACGCTTGGAATTACAGGT
>neg_control_2658490:2658640	GGATGCTAACTAAACACCGCTAGCTCAACTACGTTGAAGGTGAGTCGCTGATTATGGCGCTGAAAGACCTCGCAGTTTCTTCAGGTTCCGCCTGTACGTCAGCAAGCCTCGAACCGTCCTACGTGCTGCGCGCGCTGGGGCTGAACGACGAGCTGGCACATAGCTCTATCCGTTCTCGAGACGCTTGGAATTACAGGT
>neg_control_3774910:3775060	GGATGCTAACTAAACACCGCTAGCTACTGTGTTCTTAAAACGCGGTCTTTGAAAACCCAGTCATCTCCTGCAGGCCCATTTCGCGGCCCAGTGCGGTCATTGGGTGCACAACGACCAGTCCGCGAACACTTTTCTTCAGCTTGCCCATATCAGCCTGCTCTTTTTTGGTAATTGCTCGAGACGCTTGGAATTACAGGT
>neg_control_2660733:2660883	ACCTGTAATTCCAAGCGTCTCGAGATGGTTTTCACGGATAAAACCGGTTGCCAGCAGCGTTTGTTCCAGATGACCATAAAAACGCTCCAGATCATCGACCAGCGGATACGGCGTCTCTTCATGCTCGACCTGCTCGCCGTTTTCCTGAGTTGCCAGCCAGGCCATGCGCACTTCGCTAGCGGTGTTTAGTTAGCATCC
>neg_control_2764293:2764443	GGATGCTAACTAAACACCGCTAGCCAGCGGTCGGCCCTGAATCTGGAGCTTACCTGTTGTGATATGCAGGCTCACAGTCAATTCGTCCTGATAGCTGGTGGAAATAATTTTCCACACTACGGTATGAGCGTTACGAGAGTGTTCTCTGAACTCTATATGCGATTCATCTGCTGACTCGAGACGCTTGGAATTACAGGT
>neg_control_2337088:2337238	GGATGCTAACTAAACACCGCTAGCGTCGTTGGTGACGTAATCGGTAAATACCATCCCCATGGTGACTCGGCGGTCTATGACACGATCGTCCGCATGGCGCAGCCATTCTCGCTGCGTTATATGCTGGTAGACGGTCAGGGTAACTTCGGTTCTATCGACGGCGACTCTGCGGCGCTCGAGACGCTTGGAATTACAGGT
>neg_control_3651550:3651700	GGATGCTAACTAAACACCGCTAGCAATTCTTTTACCAGATGGTATTTCTATTTCCACCCCATAATTTATATCTTTTTCATTAGGCAGTGGCCTCTTTAAATAAGGCGTGTGTGACATTTTTTTTGGGTTAAGCGTCTCGTATTGAAATACTTCGAATTGATATTCAGACATTTCCTCGAGACGCTTGGAATTACAGGT
>neg_control_856671:856821	ACCTGTAATTCCAAGCGTCTCGAGAGTTCGTAAGCTCCCTGGCGACCCGCATTCTGGAAATCACCCCGGAACGCGTGATCGACTTTAGCGGTAATTACGAAGATTACCTGCGTAGTAAAGGGATCGAGTAAGTGATTATCCGTCACCCCGATACTGTCGGGGTGACGGCGGCTGGCTAGCGGTGTTTAGTTAGCATCC
>neg_control_3827623:3827773	ACCTGTAATTCCAAGCGTCTCGAGCTTACGCGTGGCCTCACTGGTAATTGCGATGGCGGCCGGATATGCGCTGGCGTGGTTTATGGGCATGTTGCCAGAAAGCAACGAACCTATGACGCAAGAACTGATTATGGTGCCAACGCCGCTCTATTACGGTCTTGGCATTGAATGGAGGCTAGCGGTGTTTAGTTAGCATCC
>neg_control_1154912:1155062	GGATGCTAACTAAACACCGCTAGCCGCATGGTGACCTCTTCCGGCCTGATAGCTGGCTACCAGTTTTTCGAAATCAGGTCGTAACCATGGATACCATCTCATGCGTCCAACTCCTTCACCCAGTGGGTCACGGTAGTGCGGATTGCATCCATCACGGCCTCCAGCGGCTGGGTGCTCGAGACGCTTGGAATTACAGGT
>neg_control_492539:492689	GGATGCTAACTAAACACCGCTAGCCTGAACGCGATCGGTGACCGAAGCCAGTCTTTCCAGCGCAGCGTTATTCACCGGCCGCGCGCGGGTAGCGGCTGCCGGTTCACTCTTTTTTGCTTTGGTTGCTCCCTGCACGCGCTGCAACTGCTGGCGCGCCGCCAGCACCTGGCTGGTCTCGAGACGCTTGGAATTACAGGT
>neg_control_4500205:4500355	ACCTGTAATTCCAAGCGTCTCGAGCCCTTCTTGTCGGTAATTTCACAAGTTGTCCCATACTTGCAAGATCGCGCATCAGCTCCGGTATACGTCCCGGTGAAGCGCCCTGCAATGTCATCAGCATTCTCATCACCATTCCGCATGATTCTGAGAAACTCAGTTGATTCGGCCAGTGCTAGCGGTGTTTAGTTAGCATCC
>neg_control_1876892:1877042	ACCTGTAATTCCAAGCGTCTCGAGTAAAGATGAAAAAAACAACGATTATTATGATGGGTGTGGCGATTATTGTCGTACTCGGCACTGAGCTGGGATGGTGGTAACGTCACCTCTAAAAAATAGCAAAGGCTGCCTGTGTGCAGCCTTTGTGCAATTTAAGCGTTAACTTTTAATGCTAGCGGTGTTTAGTTAGCATCC
>neg_control_3820853:3821003	GGATGCTAACTAAACACCGCTAGCCGGTTGGGATACAGCGCCTCAAAACCCAGCTCTTCGAGTTCGGTTTTAATGTGGTGGATACCTAAACGGTGCGCCAGCGGGCTATAAATTTCGAGAGTTTCACGGGCGATGCGGCGACGTTTGTCCGGGCGAAGTGAGCCCAGCGTGCGCCTCGAGACGCTTGGAATTACAGGT
>neg_control_3854052:3854202	GGATGCTAACTAAACACCGCTAGCGCCAGATTTCGCCACGCCCGTCATTCGCGAACTGCTGGCGTTGTTGTTGTGTCTGTTTTCCGGCGGGTTAGCGATGTATGGCTACTTGCGCTGGTTACGCAATGAAAAAGCGATGCGTCTGAAAGAGGACCTGCCCTACACCAACAGCTTCTCGAGACGCTTGGAATTACAGGT
>neg_control_4428100:4428250	ACCTGTAATTCCAAGCGTCTCGAGGGGCAATGGGGGAATTGCTGCTTTCGAATCTGGAATACAAATCTTTTAGTGACTTCGCTTCCGATTTACTCGGGCCGTGGGCAGGATATTTCACCGGCTGGACTTACTGGTTCTGCTGGGTTGTAACCGGTATGGCAGACGTGGTGGCGAGCTAGCGGTGTTTAGTTAGCATCC
>neg_control_3395256:3395406	ACCTGTAATTCCAAGCGTCTCGAGAGCGGCATCGGAGGCCAGTTCAGCCTCGCCAACCCCTTCCGCTGCGGTACGGATGATAAACCCGCCCTGCTCGTCGCAATACTCTGCGACCACTTTTTTCAGGCGTTCACGTTCTGATTCGCTTTCAATACGTTGGGAAACCCCAACGTGGCTAGCGGTGTTTAGTTAGCATCC
>neg_control_2039710:2039860	GGATGCTAACTAAACACCGCTAGCAGGATCTTTACATTCGAATAAGTAACGAACGCCTTTCTTGCCTGATTTATAGGTGAGTATTTTGTATCCATCGTAATCATATTTACACGATGTTGTTTCATTATTTCTATGGAATTCAACAATGCCGTCCTCAATGCCAATCATCTCGATCTCGAGACGCTTGGAATTACAGGT
>neg_control_34733:34883	ACCTGTAATTCCAAGCGTCTCGAGGCGATGTTGTAGCATCTTATCCAGCAACCAGGTCGCATCCGGCAAGATCACCGTTTAGGCGTCACATCCGTCGTCCCCTGCAAACGGGGGCGATTTTCCTCCATTTGCCTCAGTGGCTGCGTTTCATGTAACGATACATGACAGCGCCCGGCTAGCGGTGTTTAGTTAGCATCC
>neg_control_4464688:4464838	ACCTGTAATTCCAAGCGTCTCGAGCGTCGCTTACCGGTTGTCACGTCACTGTGCGGCACGCCGAGATAACTGATATTACGATGCCCCTGGTCATACAGCCGTTGCATCAGGATTTTGATTGCCCCTTCGTCGTCATAACAGACCGAAGCAAAGCCTTTTGCGTCACGCGCCAGCGCTAGCGGTGTTTAGTTAGCATCC
>neg_control_1749014:1749164	ACCTGTAATTCCAAGCGTCTCGAGAATTTGCGTCGAGTGAAGGACATCTGATTATCCCCTAATGCAGTGGCTGCAACTGTCCACCCTATCCATGACATCTCCCTGAAATTTCAGGGGTTCTGAAACTGCTCTACCTCGAACCATTCGCATAAGCCATAAGCCTTGCCATAGGTCGCTAGCGGTGTTTAGTTAGCATCC
>neg_control_1581327:1581477	GGATGCTAACTAAACACCGCTAGCTTACGTGCTTCAAATGTACCGACTGGATTGCTTAATGAAATGATTGCTTATCTCAACTCGGAAGAACGCAATCATCATAATTTTTCAGAACTTTTGCTTTTTTCTTGCCTGTCTATTTTTGCCGCATGCAAAGGTTTCATTACACTATTACTCGAGACGCTTGGAATTACAGGT
>neg_control_3348111:3348261	ACCTGTAATTCCAAGCGTCTCGAGTCGCTTGTGCCAGCGCCTTTAATTCACGGTCAACGGTGCATTCGCTACCAAGACTGGCAAAATTGCTTAAATTCTTCGCCGCGCCAAACCCCCCCGGCACAATCAACGCATCCAGTTCAGCGGCATCGGCCTGGGCCAGAGGACGGATTTGCTAGCGGTGTTTAGTTAGCATCC
>neg_control_199421:199571	ACCTGTAATTCCAAGCGTCTCGAGGCCGACCTGTCCGACTATACCAACAAGAGTTATGGTACAGACGTGACGTTGGGCTTCCCGATTAACGAATATAACTCGCTGCGTGCAGGTCTGGGTTATGTACATAACTCCCTGTCCAACATGCAGCCTCAGGTTGCGATGTGGCGTTATGCTAGCGGTGTTTAGTTAGCATCC
>neg_control_101260:101410	GGATGCTAACTAAACACCGCTAGCTAATAAAAGTCTGTTTTAAATTCTCAAAGTCGCCCTGGTAGGTATCCATGTGGTCGGCTTCGATATTGGTGACAATCGCCACCATCGGTTGCAGATGCAGGAACGATGCATCACTCTCATCTGCTTCGGCAATCAGGTACCGACCATGCCCTCGAGACGCTTGGAATTACAGGT
>neg_control_2239085:2239235	GGATGCTAACTAAACACCGCTAGCCCATCGTTGCGTTTGCCTGGATAATCTCAGCGGTGCCCGAATGGCGACGCGCATGTTGCTGAATAACGGTCATCAACGTATTGGTTATCTTTCTTCCAGCCACGGCATTGAAGATGACGCCATGCGTAAAGCAGGCTGGATGAGTGCGTTCTCGAGACGCTTGGAATTACAGGT
>neg_control_2872709:2872859	ACCTGTAATTCCAAGCGTCTCGAGCTGAGCATCCACCACTCGCTGGATCTCCACGGTTTCCAGCACTTCGAGCAGTGTCGGACCGCTGTACCACGGCATACTTTCACTTTGCGATGCCACGTTGTCGCCTTCCAGTGCAGAGAGCGGCACAAAGCGGATATCCAGATTACCCGGGCTAGCGGTGTTTAGTTAGCATCC
>neg_control_2640435:2640585	ACCTGTAATTCCAAGCGTCTCGAGGTGATCTCTTCCTGCTGAGCTTTGCGGTCTTGCCACCACCAGGCACCGCTCAGGCCGATAACCACAAACAACACCAGCCAAGTGAAGGTCATCAGCCAGCCGTCGCGTTTTTTGCGGCGTTTACCGAGGGAAAAACTCTGCATCGGCGCAGCTAGCGGTGTTTAGTTAGCATCC
>neg_control_3831262:3831412	GGATGCTAACTAAACACCGCTAGCTCTGGCGATTTATGACTTTACCAATCCGGATGCCTGCAAATGGTACGCCGACAAACTGAAAGGTCTGGTCGCGATGGGCGTTGATTGCTTTAAGACCGACTTTGGCGAACGTATCCCAACTGATGTTCAGTGGTTTGACGGTTCCGATCCCTCGAGACGCTTGGAATTACAGGT
>neg_control_3585558:3585708	GGATGCTAACTAAACACCGCTAGCGCTGCTGTCATCGTTTGAGATTGATGCTTTAGAAGCTGCACAACAGGCGGCACCGGAACTGCCGCGCGGTTTGTTGCTGGATGAGTGGCGCGACGACTGGCGCGAACTGACCGCGCGGCTGGGCTGCGTCTCTATTCATCTCAATCATAACTCGAGACGCTTGGAATTACAGGT
>neg_control_3664445:3664595	ACCTGTAATTCCAAGCGTCTCGAGTTCACCATCTTTCAGTTTGAAGCAAACCGCCGGGATGCCTTCGTCCGGGCGACCCGTACAGATGAACTCATACGGCCCCAGTTTGGCGATTTCATCCGCCAGATAAGCGGCAACCTGGTAAGAGGCGTTCTGTACTTTGGTATAGCCTTCGCTAGCGGTGTTTAGTTAGCATCC
>neg_control_1838385:1838535	GGATGCTAACTAAACACCGCTAGCGCGTCGAGTCGCTACCAGCGTGTCCCCAACGTGCGCCGGCTATTTCACCTTTTGGTTTAATATAGCTGTAACCGCTGGTCGTACCGATAAATTCTGGCCACGAACGAATGCTCACCAGCGATGCATCCTGGCGATGCAGCAGTCCACGGGCTCGAGACGCTTGGAATTACAGGT
>neg_control_292723:292873	GGATGCTAACTAAACACCGCTAGCTGTTTCAGAGCAACGTTTACTCAGACAATTGATTCATCATGAAATGAACCGGCAGGACACGCTTGTCATTCCAGATCTAAGCTGTCTTGGCAGAACTGTGGAGGACTTACAGAATATTTTATTTTTTTGCCTTCAAAAAGAAATGTTTATCTCGAGACGCTTGGAATTACAGGT
>neg_control_1167587:1167737	ACCTGTAATTCCAAGCGTCTCGAGTTGTCGTTGACATAAAAACTGCTGCAAAGTGCGCTCTTGCATCGCATGGCGTGATTTCAACGTATTGGCGATATCTCCTGAATCTGGGGAGAGGGTGGTGCAGTTGTTGATCATGAAGCAGCCTGCCGGGGTGTCTTTGCTGGTAAAGCAGCTAGCGGTGTTTAGTTAGCATCC
>neg_control_4154296:4154446	ACCTGTAATTCCAAGCGTCTCGAGCTGTTGGCATGGGCGAAGAAACATCAGATTGCGGCCGTAGGTTTGTTTCTCGGTGACGGCGACAGCGTCAAAGTGACCCAGCTTGATGAAGAGTTAGGTCATGTTGGACTGGCGCAGCCAGGTTCGCCTAAGCTTATCAACTCCTTGCTGGCTAGCGGTGTTTAGTTAGCATCC
>neg_control_3893102:3893252	GGATGCTAACTAAACACCGCTAGCGGGTTTTTTATTTAGATCTTAACTCGCTGAATAAACTCACCAAATGCGGTCAATTGCCCGGTCAGGTGGTCCAGCGTACCCTGATCAATCACTTCTCCGGTTTGCGGATCAACTTTGTTCTGAATCACGCCGCCCATAAATTCCGGCTTGCTCGAGACGCTTGGAATTACAGGT
>neg_control_1847934:1848084	ACCTGTAATTCCAAGCGTCTCGAGGCTCGCCTTGACCCGAAAGTGAAAGCGATTGTCCTGCGTGTTAATAGCCCAGGCGGCAGCGTTACCGCGTCTGAAGTGATTCGCGCTGAACTGGCAGCAGCCCGGGCAGCGGGTAAGCCTGTGGTTGTATCGATGGGCGGCATGGCGGCAGCTAGCGGTGTTTAGTTAGCATCC
>neg_control_2919228:2919378	GGATGCTAACTAAACACCGCTAGCCTAGGGTCACGGATGATGATCGGCGTTTATATCGGTCAGTACTGTATCAACGCCCTGACTTACTTCTTTATTACCTGGTTCCCGGTTTATCTGGTGCAGGCACGCGGGATGTCGATTCTGAAAGCGGGCTTTGTGGCTTCCGTTCCGGCGCTCGAGACGCTTGGAATTACAGGT
>neg_control_3985771:3985921	ACCTGTAATTCCAAGCGTCTCGAGGCCAGGCCCGTGACGCTGGTTTCGATATTGTAGTTGTCGGTCTGGATCAGCACATAACCCTGATGGCCGGCAATCATCGGGCCAACCACGATCCCCGCAATCAGCAACACAAAGAGCAATAACACTTTTAGCATGGTTATTCTCCTTGCGGCTAGCGGTGTTTAGTTAGCATCC
>neg_control_1028510:1028660	ACCTGTAATTCCAAGCGTCTCGAGAACAGTTCAGCACACGTTTATTTTCAACGTAGCGGCGGGTAGCCAGGCGGCTATCACGCTGGTCCAGGTAGTAGCCCGTTTTGTGTCCGTGCTGAATATCCACCAGCAGTTTCATTCCGTGTTCTTCAATCGGCAGCAGGGCAGGTGGCAGCTAGCGGTGTTTAGTTAGCATCC
>neg_control_1375038:1375188	GGATGCTAACTAAACACCGCTAGCCTGTTCTGGCGTCATGGCGGGCGGTTTTTCGCACATCACATGGCAGCCCGCTTCCAGTGCCATCAGGGTATGTTCGTAATGAAAACGGTTAGGTGAGCAGACGCTAACCACATCAGGTTTCACCGCCAGCAGCATGGCCTGCGGATCGTCCTCGAGACGCTTGGAATTACAGGT
>neg_control_3090397:3090547	GGATGCTAACTAAACACCGCTAGCGCCATCCACCACCAGCACGCGTTTGTCGCCATCTTTAATGGCTGGCAGGTAATTTTGCGCCATGCAGTAGCGAGTGCCATGCTCAGTCAGGGTTTCGGCAATCACGCCGAGGTTTGGATCGCCTTCTTTCACGCGGAAAATCGACGCGCCCTCGAGACGCTTGGAATTACAGGT
>neg_control_2913907:2914057	GGATGCTAACTAAACACCGCTAGCGCGTTGGTGTTAATTCTGTTTTCAGCGTCAGGCGGGTAAAGCCAATAACACCATTCAGTGGTGTACGCAGCTCGTGTGACATATTTGCCAGAAACTCGGATTTAATACGCGCCGCTTCCTGGGCGCGCTTTTTCGCCAGATCTAACTCAACTCGAGACGCTTGGAATTACAGGT
>neg_control_4076279:4076429	ACCTGTAATTCCAAGCGTCTCGAGCCGACCTCGGTGCCTTAAGCGGCGATCTCGACCGTCTGGCGCGCGGACGAAAAGCACGGGTGCAGATGCAGGTCGAAATCTTTGGCGACGAGACGCCGGGTGCAGTGTTTGAAGGCACGTATATCGTTCTGCCCGCGAAGCCATTTGGCCGCTAGCGGTGTTTAGTTAGCATCC
>neg_control_680621:680771	GGATGCTAACTAAACACCGCTAGCTCATGATTTTCAGGTGTTGGCTCATCGACATCTTCATCCTCCGGCTCGAGTTTCACTTTCGTCAAAAGCATCCGGGTGACAATGGCCTCTAATGGATGAGCATCTCCGCCTTCCAGCCTTGTATTAAGACGGGCCAGCATCTCTTGTTTCCTCGAGACGCTTGGAATTACAGGT
>neg_control_95342:95492	ACCTGTAATTCCAAGCGTCTCGAGGGCTCACGCAAAGTGTGGCGTTTCTCACCCAATGCCGCCAACAGCGATTTCACCGCCACCAATATCCATGTGACCTCGCACGGTACGGAATTTACCCTACAAACCCCAACCGGTAGCGTCGATGTTCTGCTGCCGTTGCCGGGGCGTCACGCTAGCGGTGTTTAGTTAGCATCC
>neg_control_991964:992114	ACCTGTAATTCCAAGCGTCTCGAGAAACAATATGACTGATGCGCTGGCGGCGCTTTCTGCGGCGGTTGCCGCACAGCTGCCTTGCCGTGACGCGCTGATGCAGGAGTACGACGACAAGTGGCATCAGAACGGTCTGGTGATGGATAAATGGTTTATCCTGCAAGCCACCAGCCCGCTAGCGGTGTTTAGTTAGCATCC
>neg_control_2067045:2067195	ACCTGTAATTCCAAGCGTCTCGAGCGATAACCCAGCGCACTATGCGGATGCCATTCGTTATAATGCTCGAACGCCTCTGCAAGGTTCTTTGCTGCCGTTAACCCGTCTGGTTTGGGCATGATACTGATGTAGTCACGCTTTATCGTTTTCACGAAGCTCTCTGCTATTCCGTTAGCTAGCGGTGTTTAGTTAGCATCC
>neg_control_3692392:3692542	GGATGCTAACTAAACACCGCTAGCGAAACGTACGCGTGGATTGTGCTGGTGCTCGGCTACTTCCAGGTAGTATGGCCGCTGAATCGTCAGCCGGTGCCATTGCCGAAAGATATGTCGCTGTGGCCGTCGGTGGATATCTTTGTCCCGACTTACAACGAAGATCTCAACGTGGTGCTCGAGACGCTTGGAATTACAGGT
>neg_control_126353:126503	GGATGCTAACTAAACACCGCTAGCTTCACTTTATCGCCAACGTTGACTTTCAGTTCCTTCACGACGCCTGCAAACGGCGCCGGAACTTCCATAGAAGCTTTGTCGCCTTCTACGGTGATCAGTGACTGTTCAGCGGCAACTTTGTCGCCCACTTTCACCATCACTTCAGTCACTCTCGAGACGCTTGGAATTACAGGT
>neg_control_1741997:1742147	ACCTGTAATTCCAAGCGTCTCGAGCGGTGAACTATATCTTTATTTATGGTCATTTCGGTATGCCTGAGCTCGGTGGCGTTGGTTGTGGCGTGGCTACTGCGGCGGTGTATTGGGTCATGTTCCTTGCCATGGTTTCTTACATTAAACGCGCCCGCTCCATGCGCGATATTCGTAGCTAGCGGTGTTTAGTTAGCATCC
>neg_control_3153924:3154074	GGATGCTAACTAAACACCGCTAGCTTCAGGGCTTTCGGACCATCTTCGATTAGCGTCAGCAAAATGCCTTCTGCGAAACGGTCCTGAATTTTGGCATCAACCGGTTTGGTAACATACTGTTCCACGGTGTGTACAAAGGCGTCCACTACGCCGTTAGCCACCTGACGCGGCGGCCTCGAGACGCTTGGAATTACAGGT
>neg_control_1626696:1626846	GGATGCTAACTAAACACCGCTAGCCTCAATGGTATCCCACGCCAGTTGACAGTCGGCAATCTGCGTCAGGAGTTGATGGAAGTTGTCATCAAGTTCAAAAAAATCATCCAGTTGCTTGCGCTCAATGGCAATGCGTTGCTGGTGAAGATTTTGTTCCAGTTGATAGCACTGGCTCTCGAGACGCTTGGAATTACAGGT
>neg_control_4050885:4051035	ACCTGTAATTCCAAGCGTCTCGAGCATCGCCTTCCTGACGCAATCGGGCTATCAGTTTATCGGTATGGATCACTTTGCCCGTCCGGATGACGAGCTGGCGGTGGCCCAGCGTGAAGGCGTGCTGCATCGTAACTTCCAGGGCTACACCACTCAGGGCGATACCGATCTGCTGGGGCTAGCGGTGTTTAGTTAGCATCC
>neg_control_3945370:3945520	GGATGCTAACTAAACACCGCTAGCTAGTCAGTTGCTGGGATATTTCACTTTAGCGCTTTATACCAGTGCCCCTTCAAAACTAAAGGGAGATCTTAATTATCTGCGACTTGAGTGGGGGCCAGATTTTCAACAGCATGAGGCAGGTTTGATCGGTGCTGACGAAGTGCCCATTCTCTCGAGACGCTTGGAATTACAGGT
>neg_control_4415697:4415847	ACCTGTAATTCCAAGCGTCTCGAGGTGACATTTTTCCGCCAGCATCTTTAAACACGCAGAATGCTGACCCCTTGCGCTTCCAGTTGTTGCAGGATTTCCGGGTTAGCATTTTTGCCGGTGATAAGCATATCGATTTGATCGGCACGGCTAAAAAGCATTCCCGCGCGTTCGCCAGCTAGCGGTGTTTAGTTAGCATCC
>neg_control_2787866:2788016	ACCTGTAATTCCAAGCGTCTCGAGCCTGTTCTGGCTGCACGGTCGCGACCGCTTTACTCCGCACCCGGATCTGCGCCGTGAACTGATGCGCCAGCGTGGCTATTTCGCTTACGCCTCTAACCACTACCAGACGCATCAGTAAGCGCAAAGGAATTGAGCGGATGTATGATTTTGGCTAGCGGTGTTTAGTTAGCATCC
>neg_control_102289:102439	ACCTGTAATTCCAAGCGTCTCGAGCTGAATTCTGGCGCAGCGGTGTTAGCCGGACTGCGTGAAGGCGGTATTGACGCGTATCCTGTCGACCCGAAAGAAGTCGACGTGACGCAACTGAAGTCGATGGGCTTTCAGAAAGTGTTTATCGCGCTACACGGTCGCGGCGGTGAAGATGCTAGCGGTGTTTAGTTAGCATCC
>neg_control_1289918:1290068	ACCTGTAATTCCAAGCGTCTCGAGCAGCGGCGAAATTATTACAGGAACTACAACCGCCGGTTCAGCAGGTGATTTCCCATTGCCGGGTTAATTATCGTCAATTGGTTGCCGCGGACAAACCCGGCCTGGTGCTTGATATTGCCGCACTTTCGGAAAACGATCTGGCATTTTATTGCTAGCGGTGTTTAGTTAGCATCC
>neg_control_1886883:1887033	GGATGCTAACTAAACACCGCTAGCGCATCCGGGCAAAGAGCTGGTGGTGACGGCGCTGCCGCTGTATCACATTTTTGCCCTGACCATTAACTGCCTGCTGTTTATCGAACTGGGTGGGCAGAACCTGCTTATCACTAACCCGCGCGATATTCCAGGGTTGGTAAAAGAGTTAGCCTCGAGACGCTTGGAATTACAGGT
>neg_control_3805572:3805722	ACCTGTAATTCCAAGCGTCTCGAGTATCTGACGCGCTGTCGGTTGGATGACAACATAATGATCTTTTACGCCCAGGGCATCTAATTCCCGGCGCATCTTCTTCCAGCAATCTTCGGCGTAACTCATTGTTGTGTCGGTGTAGAAATCGGTAATACCTAATGGCTCAAGGACCGAGCTAGCGGTGTTTAGTTAGCATCC
>neg_control_4108566:4108716	GGATGCTAACTAAACACCGCTAGCTCTTCGCCTTAACGCAAAATCTCACACTGATGATCCTGAATTTCCTCGGCTGAAGCACGGTTAAGCGTCAGTAGATTTCGTTGTGTCGCCAGCAATACAAATGAGTTATCACTCTGCCGTACCATCGCCAGCCCGTAGCGTCCCATATGTCTCGAGACGCTTGGAATTACAGGT
>neg_control_2887793:2887943	ACCTGTAATTCCAAGCGTCTCGAGCATAGATGGTGTTTTCACCGGCAAATTTGTCGATCGCCTGCCACTGTTTAGTGGTAATCACCCCACCCGGCAGACGACAGCGAAGCAGCATCGCGTGGCGCGGCTCCAGCTTCTGTTCAGCACGTTCGGCGCGGATGTCGCGGTCATCCTGCTAGCGGTGTTTAGTTAGCATCC
>neg_control_302765:302915	GGATGCTAACTAAACACCGCTAGCTGACTATCTGCATCAGAATATAAAAAGCAATGTTTTTAACCTATAAAAATGGCGCTGTATTTGCGCCATTTTTATCATTCAATGCATTATCTGTTTGAGCCTAAAGGGATCTCAGGGTCTGGCTCATGAGTAATTCTGTTTCGTAAATCTCTCGAGACGCTTGGAATTACAGGT
>neg_control_191221:191371	ACCTGTAATTCCAAGCGTCTCGAGGGTAGCGAAAATTGGTGAAAACATCAACATTCGCCGCGTTGCTGCGCTGGAAGGCGACGTTCTGGGTTCTTATCAGCACGGTGCGCGTATCGGCGTTCTGGTTGCTGCTAAAGGCGCTGACGAAGAGCTGGTTAAACACATCGCTATGCAGCTAGCGGTGTTTAGTTAGCATCC
>neg_control_3613542:3613692	ACCTGTAATTCCAAGCGTCTCGAGATGCTGAACTTCCTGCCCGCCACGCTGGAACTTGCAGGTGCGGCGCTGGTATTAATTCTGCTCACTTCCGTACCGCTCGGTATCTGGGCGGCGCGCCATCGCGACCGTCTGCCGGATTTCGCCGTACGTTTCATCGCGTTTCTTGGCGTGGCTAGCGGTGTTTAGTTAGCATCC
>neg_control_2935561:2935711	GGATGCTAACTAAACACCGCTAGCGATGTGGCATTCAGTCAGTTCACTATTGATTTGCCGACAGCAATCAGCAAAGCGTTGCAAAATGGCGTCTAAAGACCACTGGTGCCAGGTGTTGTTTTCCATCGCGATATCGCTGGCATTAGGCGTTGAGGCGCGGGCAACAATTTTGCCCTCGAGACGCTTGGAATTACAGGT
>neg_control_1856174:1856324	ACCTGTAATTCCAAGCGTCTCGAGCGTGCAATAGTGTCTTCTTTTGCGCCGTTAATAACCACTGTCGCACCAAGCTGTTCCGCCATTGCCAGACGTTTTTCCAGCACATCAACGACGGCAATTTCCGTTGCTCCCAGGCATTTGCACGCTTGCAACGTCATCAAACCAATACAAGCTAGCGGTGTTTAGTTAGCATCC
>neg_control_949381:949531	GGATGCTAACTAAACACCGCTAGCGCCGCTTTTTTATTCCGCGCTTCATTCTGCTACAGCGTTTTTAACACATCTTATAGTGCATCTACCATATCCCGTACCTGAGATAATAACGACTGATAATAGCTCGCGTGAAGTTCTTCCCCATCGAATACCACTGTATTACACAAGAAACTCGAGACGCTTGGAATTACAGGT
>neg_control_3049348:3049498	ACCTGTAATTCCAAGCGTCTCGAGAAATGTACTGCCCGATGTCTTTCCCCTGACGATGCAACCGTTTCAGTTCGGCAATCAGCTCTGCAGCATCCATAAAGCCGAGATTTACCCCCTGCCCCGCCAGCGGGTGAATGGTATGTGCGGCGTCGCCCACCAGCGCCAGACGGTGCGGCTAGCGGTGTTTAGTTAGCATCC
>neg_control_3562778:3562928	ACCTGTAATTCCAAGCGTCTCGAGGCTACGTCATTGATCAAATGAATAATGTGCTTCGCCATGTAATAGGCCGAAGCCGCCTTACCGCCAAAAATATTCACGCGCGGTACCCACTTCGCATCCGGGTCGGCCTTGATGCGGTTATAGCGGGTAATCACATGCAACACATTCATCGCTAGCGGTGTTTAGTTAGCATCC
>neg_control_4530226:4530376	ACCTGTAATTCCAAGCGTCTCGAGCCGTTGCTGTCGCTGCATTACGCACAATATTGATCACTGGCACTGTGTGCATCTGGTGCCGACATCGGCATTCCGCAAGCCTGACAGAACTGTTCATGTTGTGACATATGATGCTCCTTATGGTGACATCTTGATTAATAAACATACTGAGCTAGCGGTGTTTAGTTAGCATCC
>neg_control_3379382:3379532	ACCTGTAATTCCAAGCGTCTCGAGGCTTCCATTAACCGCGGTAACTCCGGCGGTGCACTATTAAACCTTAACGGTGAGTTAATTGGCATCAACACTGCAATCCTTGCGCCTGGCGGCGGGAGCGTCGGGATTGGATTTGCCATCCCCAGTAATATGGCGCGAACACTGGCGCAGGCTAGCGGTGTTTAGTTAGCATCC
>neg_control_2059408:2059558	ACCTGTAATTCCAAGCGTCTCGAGAGCATTCACATCAACGCTTTGCCCCGGGCAATCTTGAGTTCCTACCAGAAAAAGATCTTCTTTCAGCAAAGCCTGACTGGATACACCAGCCACAGGGGAATGCTCATAAATCACCGCCATATCGAGTTGGTGATTTATCAATTTTTCGTTGCTAGCGGTGTTTAGTTAGCATCC
>neg_control_2707284:2707434	ACCTGTAATTCCAAGCGTCTCGAGGAGTATCACCCCGCATTGAGTCACGGATTAAGTGATAGCTTTCCCAGGTTTTCTGCATTTCTGGGTTATGAGCCAGTTCGTTAAGCAGCTCACTATCCAGCGTTTCGCCATCCATTAAAGCGGAAAGTTGTTCTTTCTGCATGCCTAATAGCTAGCGGTGTTTAGTTAGCATCC
>neg_control_3895068:3895218	ACCTGTAATTCCAAGCGTCTCGAGAGGGGCTGGAGCGCTCCTGTCAGCGATCACTGCGCCAATGTGTGTGGTATCTAACGGCCCAAATAACAAAATGCAGCATTCTATGGGCAAGCTGAATATGTTGCACTACTTCCCGGATAAACTGTTCAGCGGCTACGATATTCAGCGCTGGCTAGCGGTGTTTAGTTAGCATCC
>neg_control_1156200:1156350	GGATGCTAACTAAACACCGCTAGCGATATGATGGATGAAGGACTCTTGCTGACGTACTTTAGTTTCCGGCGTGTAATAATAATCCAGCCCGGTTTCACCCAGCGCTACAACACCCTCTTCTGCCGCCAGACGGCGTAAATCTTCTACATCGTAGGGATCATTCTGGTTGAGTGGCTCGAGACGCTTGGAATTACAGGT
>neg_control_4392701:4392851	GGATGCTAACTAAACACCGCTAGCCGTGATCGCCTTTATGCGAAGTCGGGCGACGCGGTTTTAGCCAGTGAGAAAGTTGTTCTGCTGAAAACCGCTGAATTTTCGTCTCCTGACCTGCCAGCCAACTATCCAGCCCCAGTGAGTCAAAATGCAGTTGTCCGGTAACATCCCGCGCTCGAGACGCTTGGAATTACAGGT
>neg_control_4099704:4099854	ACCTGTAATTCCAAGCGTCTCGAGTGATGGAAATGCAGATAAAACGCTCGATTGAGAAAATCCCGGGGGGGATGATGCTCGTCCCGCTATTCCTTGGCGCACTGTGCCACACCTTCTCGCCGGGGGCGGGGAAATATTTTGGATCATTCACCAACGGGATGATTACCGGTACGGGCTAGCGGTGTTTAGTTAGCATCC
>neg_control_2700849:2700999	ACCTGTAATTCCAAGCGTCTCGAGCGGTGATGTAATCTTCCGGGAAGTGATGAGTCGCTTCAGGTAGATGCTTACGCACGATTGCCGCAATAGTGTCAACATTCAGCCCGGTTTCGGCAGAGATTGGCACGATATCGAGGAAGTTCATCTGGCTTGCCAGGAACTGCAGGTGCGGCTAGCGGTGTTTAGTTAGCATCC
>neg_control_1891611:1891761	GGATGCTAACTAAACACCGCTAGCTCTGACTTATTTTGCTTCGATAAAGCTTACACCGCAGCCACAATCTTAATTTCAACTTTATACTTCGGGTTCATCAAACCCGCTTGTACCGTGCAGCGCACCGGCGCATGACCCGCGACAACCCAAGCATCCCACGCTTTATTCATCGCCCTCGAGACGCTTGGAATTACAGGT
>neg_control_2000054:2000204	ACCTGTAATTCCAAGCGTCTCGAGTCAACTTGTAGGCCTGATAAGCGCAGCGCATCAGGCAATTTGGCGTTGCCGTCAGTCTCAGTTAATCAGGTTACAACGATTAACCCTGCAGCAGAGACAGAACCTGCTGCGGTACCTGGTTAGCTTTTGCCAACACGGAGTTACCGGCCTGCTAGCGGTGTTTAGTTAGCATCC
>neg_control_3909003:3909153	ACCTGTAATTCCAAGCGTCTCGAGTTCCACTCTTCGTTCACTTTCGCCAGGTAGCTGGTGAAGACGAAGGAAGTCCCGGAGCCATCTGCGCGGCGTACTACAGCAATGTTTTGTGAAGGCAGTTTCAGACCCGGATTCAGTTTGGCGATGGCTTCATCATCCCACTTCTTGATTGCTAGCGGTGTTTAGTTAGCATCC
>neg_control_1681104:1681254	ACCTGTAATTCCAAGCGTCTCGAGAAGAGATGGATTTAAATCTCTCTTTCGATCTGCGTGTCGAGCCACTGAGTAAATACCATCTTGATGATATTTCCATGCACCGACTGCGTGGCGGCGAAATTGTCGCCCTGGACGATCAGTACACGTTTTTGCAGCGTATCCCGCGCAGCCGCTAGCGGTGTTTAGTTAGCATCC
>neg_control_298463:298613	ACCTGTAATTCCAAGCGTCTCGAGTCTGCCGCCTGCGGTGGCTTCATGTAGCGTGGCGCTTCGGGTACCGTTGGTAATCTTGCCGTCGGCAAACTGCGACTGCTCAGGATCAAACCCGACTGCCGAGGCAATCATTTCGCGAAGCTTCATACAGGCGGCGTAAACGCCGGAGGTGCTAGCGGTGTTTAGTTAGCATCC
>neg_control_147196:147346	ACCTGTAATTCCAAGCGTCTCGAGATGTTGTGATTGAACACCAAAGCAAGCCGGATAAGAAAATGGCCTTTCGCATGATGCGTTATTCTATAGCCGCCATGCACCGGCATCTGGAGGCTGACCACGATAAGCTGCCGCTGGTGGTGCCGATACTGTTTTATCAGGGCGAGGCCAGCTAGCGGTGTTTAGTTAGCATCC
>neg_control_2927401:2927551	ACCTGTAATTCCAAGCGTCTCGAGGATCCTGTTCCTGATGCCGATGTACGCAATTCAGAAAGTACCGGCAATGCGTAAGTACAGCGGTCACATCAGCAACGTATTCGTTGTCGTGATGGGTCTGATTGCAATCTCCGCAATCTTCTACTCTCTGTTCAGCTAAGTCCTTTCGCGGCTAGCGGTGTTTAGTTAGCATCC
>neg_control_1618079:1618229	ACCTGTAATTCCAAGCGTCTCGAGAAACCACGCAGCCAGTTGTTACTTCTTGTGCCAATGTCGTGGTTGTTCCCCCATCGCAGGAACACCCACCGTTTGATTTAAATCACATGGGTACTGGCAGTGATAAGTCGGATGCGCTCGGCGTGCCCTATTATAATCAACACGCTATGTGCTAGCGGTGTTTAGTTAGCATCC
>neg_control_2966025:2966175	ACCTGTAATTCCAAGCGTCTCGAGACCAGGAAGGATTCTTCACTTTCGTCATACTGGCGCAACTCTCGTTGCTGTACCACCAGTACACCAAGCAACTGGCGACGTTGAATAATTGGTACGCCTAAAAACGCGCGGAAACGTTCTTCTTTTACGGAGGGGATGTATTTGAAGCTGGCTAGCGGTGTTTAGTTAGCATCC
>neg_control_918746:918896	GGATGCTAACTAAACACCGCTAGCCGAGATCCTGCTGTGAAACAGCCTTCGTTTGTGCCAGACGTTGCTGACGGGAATACGTCACCCGCGCCAGTTTCAGCTCCGCTTCCGCCTGCTGCCGCTGCGCACGTAGCTCCATCAGCGTTGCTTCGACCTCCTTAATCTGGTTTTCAGCTCGAGACGCTTGGAATTACAGGT
>neg_control_1304537:1304687	GGATGCTAACTAAACACCGCTAGCGAAAACACAACCGGAAGGCGGGTTGATCGGCGACGGTAATTCCCCTTCCAGTAACTGGATGGTTTTGTTCTTCTCCAGATCCGGATCAGGTATGGGGACTGCCGACATCAATGCCCTGGTGTAAGGATGTAGTGGATTGTGGTAGACCTCCTCGAGACGCTTGGAATTACAGGT
>neg_control_438250:438400	GGATGCTAACTAAACACCGCTAGCGAAAGACAACAAGCTGATGGCGATTACTCCGGCGATGCGTGAAGGTTCCGGCATGGTCGAGTTTTCACGTAAATTCCCGGATCGCTACTTCGACGTGGCAATTGCCGAGCAACACGCGGTGACCTTTGCTGCGGGTCTGGCGATTGGTGGCTCGAGACGCTTGGAATTACAGGT
>neg_control_3040180:3040330	GGATGCTAACTAAACACCGCTAGCATGCGATAAAGAGATTTACTCTTCGAGCGAATACGGCAGCGGCTCGATATGCAATGTATTCGCATCGTCGCGTACGCGGAAGATGCTATCCGGTTCCATATCGTTATTCATGACGACCTGTACCACGACCTGACCATCTTCCAGTTTTACCTCGAGACGCTTGGAATTACAGGT
>neg_control_3282529:3282679	GGATGCTAACTAAACACCGCTAGCCGATTTTAGATTTAGTCAGGGATTTGTTCTTTTTGATCGCCAGGGACGTCCTGAATGAAAACATTCACGCCACGTTGTTTAATAAAACGTAAGTCCGTGAGATCCTGGTCATCGACATAAACTTTACTGCTGATTTGCTTTTTCCCTTCCCTCGAGACGCTTGGAATTACAGGT
>neg_control_955344:955494	GGATGCTAACTAAACACCGCTAGCTGCTCGATGACCGTCTGCGCGCGTTTTATGATCCGGAGAATGAACTGACCGGCAGCATGCTGATTGACCTACAATCCGGTAACGAAGATCGTGGTATTTGCGGCCTGCCGTTTACGCGTCAGTCCGACAATCAGACCGTTTATATTCCGACTCGAGACGCTTGGAATTACAGGT
>neg_control_133069:133219	ACCTGTAATTCCAAGCGTCTCGAGATGCTGCTGCCGGATACCGTCGGTACCGGTGGTGACTCCCATACCCGTTTCCCGATCGGTATCTCTTTCCCGGCGGGTTCTGGTCTGGTGGCGTTTGCTGCCGCAACTGGCGTAATGCCGCTTGATATGCCGGAATCCGTTCTGGTGCGCGCTAGCGGTGTTTAGTTAGCATCC
>neg_control_2296044:2296194	ACCTGTAATTCCAAGCGTCTCGAGGTTGTTGTAGTGCACGGAATCCATGTATTCCTGATACACCGTGTTGCGCATTTCGTGGCAGCTAATGCAGAACTCTTCGGTATTGGCTTTTTCCATCCCGGTGTTAAAGCCACCCCAGAAGACGATGCCGCCAACAAAACCGATCAACAGGCTAGCGGTGTTTAGTTAGCATCC
>neg_control_3554164:3554314	ACCTGTAATTCCAAGCGTCTCGAGACGGTATTACCCGGCCCCTGGTCGCGCGGCAGGTTATGAATATTCTGTTCATGCAGGGAAAAACTCCCCGCCAGTGTAGCGATTTCACGCTCAGCAACATGGCGCGGCACACCAGCTAATAGAACTTCTCCACGCATCTGCACAATGTTCGCTAGCGGTGTTTAGTTAGCATCC
>neg_control_1298109:1298259	GGATGCTAACTAAACACCGCTAGCTGCTGTGATAACGCGTACCCCAGACGATGGTAGAACTGATCGCCCCTGGCCCCGCCATCAACGGCAACGCCAGTGGCACCACACCAATGCTTTCACGTACCGCGGTTTCTGATTTTTCTTGCTTGTTCTGTTTATCCTCGCCAAGCTTGCCTCGAGACGCTTGGAATTACAGGT
>neg_control_3921982:3922132	ACCTGTAATTCCAAGCGTCTCGAGCTCATCTTGCTGGCGCGCGATATAACCTTCGTATTTAACCTGAATCTCAACCTGTTCCGCCGCCTGTTCGTCTGTCAACGCAGGGGCAAACGGCGTCAGCGTGGTTAATTTTTCATAAGTCATTTCCGGACGACGCAGCAGATCTTCACCGCTAGCGGTGTTTAGTTAGCATCC
>neg_control_3951830:3951980	ACCTGTAATTCCAAGCGTCTCGAGCACTGCGCCGACGCCATGGTCTGCATCTCTAACTGCGACAAAATCACCCCGGGGATGCTGATGGCTTCCCTGCGCCTGAATATTCCGGTGATCTTTGTTTCCGGCGGCCCGATGGAGGCCGGGAAAACCAAACTTTCCGATCAGATCATCGCTAGCGGTGTTTAGTTAGCATCC
>neg_control_187241:187391	GGATGCTAACTAAACACCGCTAGCGTTTTTGAGCATTCTGCGTCACCCCGGAGCGGTGCGGCGCGGGCTATTGCCAATGCATCGCCATAGCGTGCTCGGCGCGTATATGCCGCAATGGTCGCATATCGTCGGGCAGATGCAGTTTGATCTGTTCCACGCCTACACGGTGGATGACTCGAGACGCTTGGAATTACAGGT
>neg_control_3995104:3995254	ACCTGTAATTCCAAGCGTCTCGAGCATGCCAACCTCTCCACCACGCAAATCTATACTCATCTTGATTTTCAACACCTTGCCTCGGTGTACGATGCGGCGCATCCACGCGCCAAACGGGGGAAATAATGCGTTTTTACCGGCCTTTGGGGCGCATCTCGGCGCTCACCTTTGACCGCTAGCGGTGTTTAGTTAGCATCC
>neg_control_2409361:2409511	ACCTGTAATTCCAAGCGTCTCGAGATTCACCGTTCACAACTTATCCTTGTTAATTGAGGGGGATGACTTGATTCTGCCATAAAAAAGCCCCGACGAGACGGGGCTAAATCATGATCAGGTGTTTCACTGAATAATAACATCGCCATTTGGCTGTTTGGTCACAGTAATTTGCTCGCTAGCGGTGTTTAGTTAGCATCC
>neg_control_4585852:4586002	ACCTGTAATTCCAAGCGTCTCGAGGGTGCCGAAACTGGATATGGACTATTTTGAGTGAAATATCAGGCCGGATGCGGCTGCGCCTTATCCGGCCCATAACCCCTTACTTCCTCAACCCCGCAAACGCAGCCCGAATCTCTTCCTCCGGCAGCTGGATCCCGATAAACACCATCGGCTAGCGGTGTTTAGTTAGCATCC
>neg_control_7241:7391	GGATGCTAACTAAACACCGCTAGCTGCTGGCAATCACTCGCGGTCTTCATGGCGTCGCCCGGCTCATGCAGGGCTTTGTCCCGTTGATGGCGATAATCTGGGTACTGACCAGCCTGGTAATTTGCGTAATGAATATCGGGCAACTTCCCCACGTCATTTGGTCTATTTTTGAGACTCGAGACGCTTGGAATTACAGGT
>neg_control_4550936:4551086	ACCTGTAATTCCAAGCGTCTCGAGTTGACAGCAATCTGCCGGTTGCCCGCCCGTCATGGGATCATTCTCGTCTGGAATCACGCATTGTGCATCTCGGTTGCGGGGCGTTTCACCGCGCGCACCAGGCGCTGTATACCCATCATCTGCTGGAAAGCACCGACAGCGACTGGGGCAGCTAGCGGTGTTTAGTTAGCATCC
>neg_control_3085697:3085847	GGATGCTAACTAAACACCGCTAGCCTTTGTCGGTTTTTTCCCACGGGAAATGTTCACGACCAAAGTGACCGTATGCTGCGGTTTCTTTGTAGATCGGGTGCAGCAGATCCAGCATCTGAATCAGACCGTATGGGCGCAGGTCGAAGAACTCACGTACCAGCAGGGTCAGTTGTTCTCGAGACGCTTGGAATTACAGGT
>neg_control_3288255:3288405	GGATGCTAACTAAACACCGCTAGCAATAGTCTTGCTGCGAACCGGAGGCATACAGACTTACCCCATCAAATATTGTCTGGCTGATGTTGAATTGAATTTCACTTTTTTGGCGACTGTTATAGTCCCAATTGCGGGTATTGGCTTCATTAAAACTAAAATAGCCATCGTTGGTATCTCGAGACGCTTGGAATTACAGGT
>neg_control_3541854:3542004	GGATGCTAACTAAACACCGCTAGCAGGAACTCCGGATTCAAGCATTATTTTGGCTATATGCAGGGCTTTGGATTGTTCCCCCTCCTGCCGCAATCTTTCCGCAATAGTCATTAAACTCTCCTTGTGTTTCGGTGAACGTTCGGCAACGCCGTCGATAAAATCGTTAAAACGTACCTCGAGACGCTTGGAATTACAGGT
>neg_control_1547991:1548141	ACCTGTAATTCCAAGCGTCTCGAGGCTGGGCACTAACCCGCTGCATCCGAACGTGGTGTCTAACCCGGTTGTTCGTCTGTATGAACAAGACGCGCTGCGGATGGGTAAAAAAGAGCAGTTCCCGTATGTGGGTACGACCTATCGTCTGACCGAGCACTTCCACACCTGGACCAAGCTAGCGGTGTTTAGTTAGCATCC
>neg_control_2026886:2027036	ACCTGTAATTCCAAGCGTCTCGAGTTCGGCCACAATCCCCAGCGTGATGGCGACGATTTCCGCAGACAATATAAAATCGGTACGAATCGCCCCTTTTATTTTGTCCTTTTCAAACTTCAGCGGATCCTGCGCCGCCAGCTTCTCCAGACGCTGCTGGCTCTGCGCCGGATCTTCGCTAGCGGTGTTTAGTTAGCATCC
>neg_control_1738488:1738638	ACCTGTAATTCCAAGCGTCTCGAGGGCCCGTAACAATAGTCAGGATGGTCTGACCTTTACCGACCTGCTACGTTCTAAAACCTATCGCGGCAACGTGCTGATATACGCAGCCTGTTCAGCCAGTTTTTTTGCATGGCTGACCGGTTCACCGTTCATCCTTAGTGAAATGGGCTAGCTAGCGGTGTTTAGTTAGCATCC
>neg_control_1181208:1181358	ACCTGTAATTCCAAGCGTCTCGAGCCGGGCGCAGCAGGAAGTTGATCAATTTCAGCGCGCCTTCTTTGTTTTTGGCATTTGCCGGGATCGCCAGGCTGTCCATCCAGAAAATGCCGCCTTCTTTCGGCCACACCACGTCAATTGGCGTACCCGCCTGGCGTGCAACGAAAGCAGGCTAGCGGTGTTTAGTTAGCATCC
>neg_control_1263433:1263583	ACCTGTAATTCCAAGCGTCTCGAGTTTTGCGGCTTGTACGCTGGCGCGGCAGATCTTTGAATCGCTCTCTACGGTCACAGTGTTGCTGGTAGGCGCGGGCGAAACTATCGAGCTGGTGGCGCGTCATCTGCGCGAACACAAAGTACAGAAGATGATTATCGCCAACCGCACTCGGCTAGCGGTGTTTAGTTAGCATCC
>neg_control_1320572:1320722	GGATGCTAACTAAACACCGCTAGCACTGGATAACGCCCTGCCTGCGGGTGTGGAAAGTGAACAATCACCAAACTGCCGTGTGCTGCGCTTCCCCCCTGTCAGTCCACTGCTGGATGAAGACGCCCGCTTATGCTCCCTTTCGGTTTTTGACGCTTTCCGTTTATTGCAGAATCTCTCGAGACGCTTGGAATTACAGGT
>neg_control_11018:11168	ACCTGTAATTCCAAGCGTCTCGAGATTTCAAACGTAGACATCTCTTTGTCGGCTTTCAGCTTCAATCGCTTTGAAACATCGAGCAAAATGGCCCGATACAATTTACCGTGTCCGCGCAGTTTGTTGGCGATACTATCGCCACCAAAATGCTGTAATTCTCCGGCAATCAGCTGCGCTAGCGGTGTTTAGTTAGCATCC
>neg_control_1909205:1909355	ACCTGTAATTCCAAGCGTCTCGAGGAAGTCGAAACAGGTTTACTTCTGACACCGTGGCCGTTAGCAACGATGGTGATGGCTCCGCTGGCAGGCTATTTGATTGAACGCGTACATGCAGGATTGCTGGGGGCTTTAGGGTTGTTCATCATGGCTGCGGGGCTTTTTTCCCTGGTTGCTAGCGGTGTTTAGTTAGCATCC
>neg_control_1472576:1472726	ACCTGTAATTCCAAGCGTCTCGAGTCTACGTAATCTCGGGCTGGACGTGCTGGATGTGGTTAACCTGCGCGTTATGATGGGGGATGGTCATGGCCCAGCGGAAGGATCGATTGAGGCCAGCCTGACCGTGCTGGCAGAGATGCAACAACAAGGCCTGGTAAAACATATTGGCCTGCTAGCGGTGTTTAGTTAGCATCC
>neg_control_2509083:2509233	GGATGCTAACTAAACACCGCTAGCTATCATGACGCCACCAACGGTTTTTGCGCCACTCATAATTGCGATGCCAGTAGTCACGGTCGCGCCAGTGACCACCGTCCCAGTAATTACCGTAATGATCGCGATCGCCAATTTGTAATTTGATTGATGGCAGTAGGGTGATTTCACCTGCTCGAGACGCTTGGAATTACAGGT
>neg_control_1256144:1256294	ACCTGTAATTCCAAGCGTCTCGAGAACCGGAATGGTCCATGCACGCACTTCTTTCACCCCAGCGGTGAAGTAAGTTTGCAGGTTCAGCAGTTTATAACCGGCACGGATCACACGGTTCAGGCCCGGCTCTTCCAGCCCAAGCTCCTGCATAAACTCGTCACGTTCTTCGTCGTCGCTAGCGGTGTTTAGTTAGCATCC
>neg_control_2092699:2092849	ACCTGTAATTCCAAGCGTCTCGAGGGCACTGCGCAAGCGGCGATGGATCAGGTACGTGAGCGCGAGCTGTTTGATCTCATCAAAGCCTGTACCCAACCGGTGCTGGGCATCTGCTTAGGGATGCAACTGCTGGGGCGGCGCAGCGAAGAGAGCAACGGCGTCGACTTGCTGGGCGCTAGCGGTGTTTAGTTAGCATCC
>neg_control_3881253:3881403	ACCTGTAATTCCAAGCGTCTCGAGGGTTATAGGCACCGCCAGGGTTATCCGCCACCTGGCGAGCCGCCGCGCGCGCCAGTTGGTTAGATTTACCTTCAACGAAGTTATCAAACGTGTGTTTGACGTTTACGTTAGAACGATAGGTCGGTTCTGCCGGGGCCGGGACGTTATCCCGCTAGCGGTGTTTAGTTAGCATCC
>neg_control_3219941:3220091	ACCTGTAATTCCAAGCGTCTCGAGATGCGGTGGATATCGATCTGGCACGCATCAGTAAAGAAATCATCGACTTCTATATCAACCAGGGCGTTAATCGTATTGGTTTTATTGGCGGTGAAGATGAGCCTGGCAAGGCGGATATTCGTGAGGTCGCCTTTGCGGAATATGGCCGACGCTAGCGGTGTTTAGTTAGCATCC
>neg_control_1841923:1842073	ACCTGTAATTCCAAGCGTCTCGAGGTGCTCCCAAAACTGCTTGTCGTAACGATAACACGCTTCAAGTTCAGCATCCGTTAACTTTCTGCGATAGCAGCAGATATGCCAGTAAAGAAATCCCATTTGACTATTTTTTTGATAATCTTCTTCGCTTTCGAACAACTCGTGCGCCTTGCTAGCGGTGTTTAGTTAGCATCC
>neg_control_232564:232714	ACCTGTAATTCCAAGCGTCTCGAGGGGGAATCGGTGCCTTTTTATTATCTGGTTTGTCAGGAATCTGGCATGTTGTTGTTTTTCACAAACAACGTCAGCTTATCGCCTGGTTGCAGATTCGCAGTGTCGCTGTTCCAGCGCATCACATCTTTGATGTTCACGCCGTGGCGTTTAGCTAGCGGTGTTTAGTTAGCATCC
>neg_control_1287562:1287712	GGATGCTAACTAAACACCGCTAGCGGGCGCTTTTTTATGCGCACGGAACTGGAAGGGATTTTTAATGATTCCACCCTGCTGGCGGATCTCGATAGCGCATTGCCAGAAGGCTCCGTGCGTGAGCTGAATCCTGCCGGTCGTCGCCGGATAGTGATTCTGGTCACTAAAGAAGCGCTCGAGACGCTTGGAATTACAGGT
>neg_control_2222315:2222465	ACCTGTAATTCCAAGCGTCTCGAGGCCCGATCAACGGATATTGTTTGCTGGCAATGAGCAGTTTGGTTAAGTCACGGGCAGTTGAAACGTTATGCACCGACAATCCGGTAGGTTCAACAAAGCGCGTGTTGTTCATTCCGAGCGATTTCGCTTTCGCATTCATTGCCTTAATAAGCTAGCGGTGTTTAGTTAGCATCC
>neg_control_2958706:2958856	ACCTGTAATTCCAAGCGTCTCGAGGCTCCTGTGCCAGCCCGCGACGCCAGATGTTTAGCTGCATTAGCAGTGAAGCCAGATGCCCCACCAGTTCTGCAATTAAGCCGCTCGATTCATCATAAGGTAGAACCGATTGCCACTCGCCCTGCGCGCTCTCCATCGCGTAGCCCAACAGCTAGCGGTGTTTAGTTAGCATCC
>neg_control_3031551:3031701	GGATGCTAACTAAACACCGCTAGCCGGCGATGCGTCCGGTAAAATAAGCATTACGTTATGCTCACAACCCCGGCAAATGTCGGGGTTTTTTTATTTAAGCTGGGTAAATGCAGATAATCGTTTTCTGGCTTCGCGATTTGTCGCCTGCATCACCATCCACGGACTGAACGCCCACTCGAGACGCTTGGAATTACAGGT
>neg_control_3688190:3688340	GGATGCTAACTAAACACCGCTAGCGTCTGCTGCGAATTATTAGTCGTCGTCGTCTTAACCCGGATAACGAGTAATTGAAGATGAATGTGTTGCGTAGTGGAATCGTGACGATGCTGCTGCTGGCTGCCTTTAGTGTTCAGGCAGCCTGTACCTGGCCTGCCTGGGAGCAGTTTACTCGAGACGCTTGGAATTACAGGT
>neg_control_2606545:2606695	ACCTGTAATTCCAAGCGTCTCGAGTTCTCGCCGCCCTGAAAACGCAGTTCCCCGGCGCGGTGCTGGATGAAGAGCGACAAACGCCTGAACAGGTCACCATTACGGTGAAAATCAATCTGCTGCCTGACGTTGTACAGTATCTTTATTATCAACATGATGGCTGGCTTCCGGTCCGCTAGCGGTGTTTAGTTAGCATCC
>neg_control_1514273:1514423	ACCTGTAATTCCAAGCGTCTCGAGTCTATCGCCACCGGCGAGCACATCATCAGCCATACCGCGTCGTCCATTAAGCGTACTCATATGGAACTTGGTGGCAAAGCGCCAGTGATTGTTTTTGATGATGCGGATATTGAAGCAGTGGTCGAAGGTGTACGTACATTTGGCTATTACGCTAGCGGTGTTTAGTTAGCATCC
>neg_control_4337247:4337397	ACCTGTAATTCCAAGCGTCTCGAGCGTCGTTGGATGCGCAGATGGCATACAGCGGGGAGGTGGTGGCATGCATCATGTAGGCCTGGTTGAAGCGGGAGAAGTTAATCGCCCCACGACCTTCACGTACATGAATATAAGAAGCCTGTGACAGCGCATTCAGCAGTTTGTGGGTGGGCTAGCGGTGTTTAGTTAGCATCC
>neg_control_4139425:4139575	ACCTGTAATTCCAAGCGTCTCGAGATCAGCCATACAAATGGCGGGCTGCGTCAGTTTGCCCGGTGCCGGGAAGCGTTGCTCACCGTAGATTTGCTGGAGTAACTGGAAGCAGACGTCGCGTACGTCCAGGGCACGTTCTTGCAGGTAGCTGCTGCTGGAACGGGAAAACTCTTCGCTAGCGGTGTTTAGTTAGCATCC
>neg_control_3428810:3428960	ACCTGTAATTCCAAGCGTCTCGAGGGCGATTTGCTGTGGGCTATCGGATTACCAAAAACAGCATAGGTTTCCATTATGTTACCCCTGTCGAAACAGTTCACCCGTCAGGGCATCGCGGATTTCTGAAGGATTTAAACGCCCCCCCGTTTCACCAGGCACAACCGGGAACGCCGCGCTAGCGGTGTTTAGTTAGCATCC
>neg_control_4444604:4444754	GGATGCTAACTAAACACCGCTAGCCACCCAGACGCAAGTTGGCACTCACCATCCCCGCTGCTTTTTCCCCACGGGTAAAGATGGGGTTTATCATCGCAAGGTTGAAGTTACGGATATTGACGTTGCCACCAAGATTACGGCGGCCTTGCGGATCGGTCACCTGCACCTGTCCATCTCGAGACGCTTGGAATTACAGGT
>neg_control_4370065:4370215	GGATGCTAACTAAACACCGCTAGCTCATTTCAACTTCGGTAGCAGCACCCACTTTGATAACTGCAACGCCGCCTGCCAGTTTCGCTACGCGTTCCTGCAGTTTTTCACGGTCGTAGTCAGAAGTTGCTTCTTCAATCTGCTGACGGATCTGAGCAACACGGCCCTGGATTGCAGCTCGAGACGCTTGGAATTACAGGT
>neg_control_4106413:4106563	GGATGCTAACTAAACACCGCTAGCAAGGAATCTGCCTTTTTCCGAAATCATTAATACAGTTTTTTCGCGCAGTCCAGCCAGTCACCTTTGAACGGACGCTTCATGTTTTCGATAGCGTCGATGATGTCGTGGTGAACCAGCTGTTCGTTCTGGATACCTACACAACGACCGCCGCTCGAGACGCTTGGAATTACAGGT
>neg_control_2364439:2364589	ACCTGTAATTCCAAGCGTCTCGAGAAGGGCGACATATTGGCGCAAAAGGTACCGCTATTTTTTCATTTCATGCCATTAAAAATATTACCTGTGCTGAAGGTGGCCTGATTGTAACTGATAATGAAAACCTTGCCCGCCAGCTACGGATGCTGAAATTTCACGGTCTGGGTGTCGGCTAGCGGTGTTTAGTTAGCATCC
>neg_control_2542057:2542207	ACCTGTAATTCCAAGCGTCTCGAGAATGCTTTCCGCCATTGGTGTGCGCACGTATCCCGGGCAAATGGCGTTAACGCGAATACCAGACTGCGCGTACTCCACCGCCAGCGATTTTGTCAGGCCAACAATCGCCGCTTTCGTTAAGGCGTACGCCGTTTCGCCAGGATCGGCCACGCTAGCGGTGTTTAGTTAGCATCC
>neg_control_4242595:4242745	ACCTGTAATTCCAAGCGTCTCGAGCCTTCGGGCTGGGCGGTCGTTTCTTTCAGTTGCAGTTTTTGCTCGCCGCCAAATTTAAAAGCGTCGGAGAGGTAATTTTTGCCGGTTTCGCCGTCGCTGAGCGCCAGTTGCCACTCATCGCCCGCCGGGTAAAGACCAAAGTTATAGGTTGCTAGCGGTGTTTAGTTAGCATCC
>neg_control_1217208:1217358	ACCTGTAATTCCAAGCGTCTCGAGAAGGCTTTGGGATTTTAATATTTATTCTGTTAATCGCCTGCGCCGCTGCCTTCCTGCTTGATAGATATTTCAATAAAAGCGCAACGCCTGAAGAGATCCTGCGACGGGCAATAAATAATGGGGAGATCGTCCCTTTTTACCAACCTGTGGGCTAGCGGTGTTTAGTTAGCATCC
>neg_control_2104896:2105046	ACCTGTAATTCCAAGCGTCTCGAGGTTACTTAACCTCATGCATATATATATCATCGAAAAAGAAATAACTAACAAGCCTACATTATGCACTTTCTTCGATGGTATGCTATAAATAGCATTATTGACTTTTCTGATATTTAGATCTAATACACTTTCCGTCAATAAACATGACAGGCTAGCGGTGTTTAGTTAGCATCC
>neg_control_3545064:3545214	ACCTGTAATTCCAAGCGTCTCGAGCGATTGCCACCATTTTCAATGCCGATATGGGTAAAACCCTGCTGTACGGTACTATTCTGGCAATCCCGACCGTGATTCTCGCCGGTCCGGTTTACGCTCGCGTGTTGAAAGGTATCGATAAGCCAATTCCGGAAGGTCTCTACAGCGCGAGCTAGCGGTGTTTAGTTAGCATCC
>neg_control_3914298:3914448	GGATGCTAACTAAACACCGCTAGCCGCAACCGTGGTACTGAGCCGTCAGATCGCGTCTCTGGGTATCTACCCGGCCGTTGACCCGCTGGACTCCACCAGCCGTCAGCTGGACCCGCTGGTGGTTGGTCAGGAACACTACGACACCGCGCGTGGCGTTCAGTCCATCCTGCAACGCTCGAGACGCTTGGAATTACAGGT
>neg_control_1170256:1170406	ACCTGTAATTCCAAGCGTCTCGAGCTCCATATACAGCGAGAAACCGATGGTTTCCATTGAGCCGCTTTGTTCTTCGCCAAGCAGTTCACCCGCGCCGCGAATCTCCAGATCGTGCGTTGCCAGCGCAAAACCTGCCCCGAGATCTTCCAGCGAGGCAATTGCTTCAAGACGTTTGCTAGCGGTGTTTAGTTAGCATCC
>neg_control_1188666:1188816	ACCTGTAATTCCAAGCGTCTCGAGAGGCTGGATCATCTTCATCAGCCAGGGCACGTCACGTTGCGCCCATAAAAGCTGCCCGTTCTCATCATAAATTAGCGTCATGGTGGGGCTTTGCTTGTCGATATTTTCGGGTAACTCGACATGCAACTTATTGTTTTCCCACTTCGCAAGGCTAGCGGTGTTTAGTTAGCATCC
>neg_control_2171465:2171615	ACCTGTAATTCCAAGCGTCTCGAGGAGCCTGCTTAGCGATGGGCGTTAAACCATCCATGATGGGTTTAATCACCCGTGGCATTAGCAGCATCACTGCCGCCGTTTTTACCGCCAGCTGCAATACACCTTTGACATCGTAACCCGCGAGGATGCCGATAATCAGCCCCATCACAAGCTAGCGGTGTTTAGTTAGCATCC
>neg_control_3347075:3347225	GGATGCTAACTAAACACCGCTAGCAATCCACTTCGTTTCAAAGTCTCCTCGCCATCGGGCTACGTGCGTAGCCGTCAGGCGTGGATTTTACGGCAGATGTATCAGTTAGGCGGTGAGCCGTTTATGCAACAACACCAGCTGGATTAAGCTTCGCGCGAAGTGAGGGCCAGCGTTCTCGAGACGCTTGGAATTACAGGT
>neg_control_2684566:2684716	ACCTGTAATTCCAAGCGTCTCGAGCAATGTTGGCGATGTCGTGAAACTGGTCGCTCCGGCAGGTGATTTCTTTATGGCTGTCGCAGATGACACACCAGTGACGTTAATCTCTGCCGGTGTTGGTCAAACGCCAATGCTGGCAATGCTCGACACGCTGGCAAAAGCAGGCCACACGCTAGCGGTGTTTAGTTAGCATCC
>neg_control_1425068:1425218	GGATGCTAACTAAACACCGCTAGCATACATTTCAGGAGAAAGCATCCCCTTAGCTTTTGCTTCATTGAGCTGTTTCTGTTGTTCTACCAGACGATTAAAAGCAGTTCCGACAGGATCAAGTTGAGCAATCAGACGTTGCAAAGCAACAACCTGTTCATCATGCGCTTTTGCTGCCTCGAGACGCTTGGAATTACAGGT
>neg_control_4426082:4426232	ACCTGTAATTCCAAGCGTCTCGAGCTTTTGGTTGACCCTTCATCTACCGCGCACGAATAAAACTGCCATCCGGCTGGCGGGTGAACAGGACCTGTTGATTATTCCCCGTATCAATGGTTAAGCCCGTCACCACGCCGCTGGCGTTCTGGCGGATTTTCACCATCTGCCCGTTTTGCTAGCGGTGTTTAGTTAGCATCC
>neg_control_1429268:1429418	ACCTGTAATTCCAAGCGTCTCGAGTGGCGTAATGATGGCGCTAAAACTTACCTGCTGCTTACCAATCAAGGTGATGTTTATGGTGGCTGGAATACATTAAGACCGTTTGCTATTGATAACGCAACCGGCGAACTGGTTATTGGAACCAAACTGTCCGCAAGTCTGAACGGTAATGCTAGCGGTGTTTAGTTAGCATCC
>neg_control_1906241:1906391	ACCTGTAATTCCAAGCGTCTCGAGGAGTAACCCTTCAACGACGGGGTTACTCAAGATTGAGGAAGGATTATCGTTCGGCGACCAGACGAATAATATCTTCGTCTTCAACCGATTTTTGACTCTCAACGGTCTTTTTATCTGCTTTCTCTGGTTCGTTTGCTTCGCACAAACGACGCTAGCGGTGTTTAGTTAGCATCC
>neg_control_2553896:2554046	GGATGCTAACTAAACACCGCTAGCCACATGTAGTTTCGCGTACCGGTTCTTATCTCTCATCAACCGCCGGGATCACGCTTGGCGATCCGATGGCGTATCTGGTGGCACCGCCGCTGGAAGCGACCTATGGCATTGATGCAGCCCTGAAGTCTGCCGACGTACAGCTGGCGACCTCTCGAGACGCTTGGAATTACAGGT
>neg_control_4171518:4171668	ACCTGTAATTCCAAGCGTCTCGAGCTGGAACAAGGCCCGGCGGCGGCGATTGGTTTAAGTCTGGTTATCGGTATCGTGATGGCGGAAGTATTACGCAAGCTGGGTGCAGATAAAGTTCGTGTTAAATGGCCTAATGACCTCTATCTGCAGGATCGCAAGCTGGCAGGCATTCTGGCTAGCGGTGTTTAGTTAGCATCC
>neg_control_1413632:1413782	ACCTGTAATTCCAAGCGTCTCGAGTCTACGATTACGGGATCTGCGACTTCGCCAGTTTCATCACTGCAATCGCGATGCGGATCGCTGCCAGCATTCTCATTGTGCGGATGTTCAGCGCCTTCCATTTCCTCCGGATCATTTTCCTTAGCTTCAACCTGACTCTCTTCATCGAATGCTAGCGGTGTTTAGTTAGCATCC
>neg_control_3127062:3127212	ACCTGTAATTCCAAGCGTCTCGAGTATTAAATCTGCTTTTCATACAATCGGTAACGCTTGTACGGCTCCGCCCCAATGCGTTCCAGCATGTTATTCATGCCTGTATTGGTTTCGAGGATCCATGACATCTCCAGCGCATCGATCTTCCGGCGGGCAAACGGATCGCGTAAGGCTGCTAGCGGTGTTTAGTTAGCATCC
>neg_control_4123656:4123806	ACCTGTAATTCCAAGCGTCTCGAGCCAGCACATGTTGAATTGCCGGACGCGCATTCCCTGCCCGACGGGTCAGGCGCAGCAGGCGGTATTTTTTCTGCTGGACGTTGCATAACGTTTCCAGCGCGGGCGTTGCGGAGCCAAGAATAATCGGGATTTGCTCGCTGTGCGCACGATGCTAGCGGTGTTTAGTTAGCATCC
>neg_control_1123876:1124026	GGATGCTAACTAAACACCGCTAGCTGCTATGTGCGGCGTTCAATGCGTGGTTGTTACCAGCATGGAAACTCTCCACCGTACGCACGCCCGTTCGCGAAGGCATGACCCGCGTGATGCGTGACAAGCGTTTTGTCACCTATGTTCTGACGCTGGCGGGTTACTACATGCTGGCTGCTCGAGACGCTTGGAATTACAGGT
>neg_control_848727:848877	GGATGCTAACTAAACACCGCTAGCCGGCTGTGCGCTGGCACTGGGGGCCGGGGCTTGTTGGGCTATTTACATTTTAAGTGGGCAACGCGCAGGAGCGGAACATGGCCCTGCGACGGTGGCAATTGGTTCGTTGATTGCAGCGTTAATTTTCGTGCCAATTGGAGCGCTTCAGGCCTCGAGACGCTTGGAATTACAGGT
>neg_control_1347579:1347729	GGATGCTAACTAAACACCGCTAGCCTGGCTAGCTCGCCTTCTATTATCGACAACCGATCGCGCCAGCATCTGAATGACGTCGGTCTTACTGCCTGGGACTGTGTGATCATTAGCCAAATCATTGGTTTTATTGGCTTTCAGGCGCGGACAATTGCGACATTTCAGGCTTATCTCCTCGAGACGCTTGGAATTACAGGT
